AAA	NG	L	Ghotuo
AAB	NG	L	Arum-tesu
AAC	PG	L	Ari
AAD	PG	L	Amal
AAE	IT	L	Albanian, Arbëreshë
AAF	IN	L	Aranadan
AAG	IN	L	Are
AAI	PG	L	Arifama-miniafia
AAK	PG	L	Ankave
AAL	NG	L	Afade
AAM	TZ	L	Aramanik
AAN	BR	N	Anambé
AAO	DZ	L	Arabic, Algerian Saharan Spoken
AAP	BR	L	Arára, Pará
AAQ	US	N	Abnaki, Eastern
AAR	IN	L	Aariya
AAS	TZ	E	Aasáx
AAT	GR	L	Albanian, Arvanitika
AAU	PG	L	Abau
AAW	PG	L	Solong
AAZ	ID	L	Amarasi
ABA	CI	L	Abé
ABB	CM	L	Abo
ABC	PH	L	Ayta, Ambala
ABD	PH	L	Agta, Camarines Norte
ABE	CA	N	Abnaki, Western
ABF	MY	L	Abai Sungai
ABG	PG	N	Abaga
ABH	TJ	L	Arabic, Tajiki Spoken
ABI	CI	L	Abidji
ABJ	IN	L	Abujmaria
ABK	GE	L	Abkhaz
ABL	ID	L	Abung
ABM	NG	L	Abanyom
ABN	NG	L	Abua
ABO	NG	L	Abon
ABP	PH	L	Ayta, Abenlen
ABQ	RU	L	Abaza
ABR	GH	L	Abron
ABS	ID	L	Malay, Ambonese
ABT	PG	L	Ambulas
ABU	CI	L	Abure
ABV	SA	L	Arabic, Standard
ABW	PG	L	Abasakur
ABX	PH	L	Sama, Abaknon
ABY	PG	L	Aneme Wake
ABZ	ID	L	Abui
ACA	CO	L	Achagua
ACB	NG	L	áncá
ACC	GT	L	Achí, Cubulco
ACD	GH	L	Gikyode
ACE	IN	E	Aka-bea
ACH	US	N	Achumawi
ACI	IN	E	Aka-cari
ACK	IN	E	Aka-kora
ACL	IN	E	Akar-bale
ACM	IQ	L	Arabic, Mesopotamian Spoken
ACN	CN	L	Achang
ACO	UG	L	Acholi
ACQ	YE	L	Arabic, Ta'izzi-adeni Spoken
ACR	GT	L	Achí, Rabinal
ACS	BR	E	Acroá
ACT	NL	L	Achterhoeks
ACU	PE	L	Achuar-shiwiar
ACW	SA	L	Arabic, Hijazi Spoken
ACX	OM	L	Arabic, Omani Spoken
ACY	CY	L	Arabic, Cypriot Spoken
ACZ	SD	L	Acheron
ADA	ID	L	Adonara
ADB	TP	L	Adabe
ADD	CM	L	Dzodinka
ADE	TG	L	Adele
ADF	OM	L	Arabic, Dhofari Spoken
ADG	AU	N	Andegerebinha
ADH	UG	L	Adhola
ADI	IN	L	Adi
ADJ	CI	L	Adioukrou
ADN	ID	L	Adang
ADO	PG	L	Abu
ADP	BT	L	Adap
ADQ	GH	L	Adangbe
ADS	GH	L	Adamorobe Sign Language
ADT	AU	L	Adynyamathanha
ADU	NG	L	Aduge
ADW	BR	L	Amondawa
ADX	CN	L	Amdo
ADY	RU	L	Adyghe
AEA	AU	N	Areba
AEB	TN	L	Arabic, Tunisian Spoken
AEC	EG	L	Arabic, Sa<idi Spoken
AED	AR	L	Argentine Sign Language
AEE	AF	L	Pashayi, Northeast
AEK	NC	N	Haeke
AEL	CM	L	Ambele
AEM	VN	N	Arem
AEN	AM	L	Armenian Sign Language
AEQ	PK	L	Aer
AER	AU	L	Arrernte, Eastern
AES	US	E	Alsea
AEW	PG	L	Aion
AEX	US	L	Amerax
AFA	NG	L	Pa'a
AFB	IQ	L	Arabic, Gulf Spoken
AFE	NG	L	Putukwam
AFH	BH	L	Arabic, Baharna Spoken
AFI	PG	L	Akrukay
AFK	ZA	L	Afrikaans
AFN	NG	L	Defaka
AFO	NG	L	Eloyi
AFR	ET	L	Afar
AFS	US	L	Afro-seminole Creole
AFT	SD	L	Afitti
AFU	GH	L	Awutu
AFZ	ID	L	Obokuitai
AGA	PE	E	Aguano
AGB	NG	L	Legbo
AGC	NG	L	Agatu
AGD	PG	L	Agarabi
AGE	PG	L	Angal
AGF	ID	L	Arguni
AGG	PG	L	Angor
AGH	ZR	L	Ngelima
AGI	IN	L	Agariya
AGJ	ET	L	Argobba
AGK	PH	N	Agta, Isarog
AGL	PG	L	Fembe
AGM	PG	L	Angaatiha
AGN	PH	L	Agutaynen
AGO	PG	L	Tainae
AGP	PH	L	Paranan
AGQ	CM	L	Aghem
AGR	PE	L	Aguaruna
AGS	CM	L	Esimbi
AGT	PH	L	Agta, Central Cagayan
AGU	GT	L	Aguacateco
AGV	PH	L	Agta, Remontado
AGW	SB	L	Kahua
AGX	RU	L	Aghul
AGY	PH	L	Alta, Southern
AGZ	PH	L	Agta, Mt. Iriga
AHA	GH	L	Ahanta
AHB	VU	L	Axamb
AHE	ID	L	Ahe
AHH	ID	L	Aghu
AHI	CI	L	Aizi, Tiagbamrin
AHL	TG	L	Igo
AHM	CI	L	Aizi, Mobumrin
AHN	NG	L	àhàn
AHO	IN	E	Ahom
AHP	CI	L	Aizi, Aproumu
AHR	IN	L	Ahirani
AHS	NG	L	Ashe
AHT	US	N	Ahtena
AIA	SB	L	Arosi
AIB	CN	L	Ainu
AIC	PG	L	Ainbai
AID	AU	N	Alngith
AIE	PG	L	Amara
AIF	PG	L	Agi
AIG	AG	L	Leeward Caribbean Creole English
AIH	CN	L	Ai-cham
AII	IQ	L	Assyrian Neo-aramaic
AIJ	IL	L	Lishanid Noshan
AIK	NG	L	Ake
AIL	PG	L	Aimele
AIM	IN	L	Aimol
AIN	JP	N	Ainu
AIO	IN	L	Aiton
AIP	ID	L	Burumakok
AIQ	AF	L	Aimaq
AIR	ID	L	Airoran
AIS	TW	L	Amis, Nataoran
AIY	CF	L	Ali
AIZ	ET	L	Aari
AJA	SD	L	Aja
AJG	BJ	L	Aja-gbe
AJI	NC	L	Ajië
AJP	JO	L	Arabic, South Levantine Spoken
AJT	IL	L	Arabic, Judeo-tunisian
AJU	IL	L	Arabic, Judeo-moroccan
AJW	NG	E	Ajawa
AKA	MM	L	Akha
AKB	ID	L	Batak Angkola
AKC	ID	L	Mpur
AKD	NG	L	Ukpet-ehom
AKE	NA	L	'Akhoe
AKF	NG	L	Akpa
AKG	ID	L	Anakalangu
AKH	PG	L	Angal Heneng
AKI	PG	L	Aiome
AKJ	IN	E	Aka-jeru
AKK	NG	L	Arigidi
AKL	PH	L	Aklanon
AKM	IN	E	Aka-bo
AKN	BR	L	Amikoana
AKO	SR	N	Akurio
AKP	GH	L	Siwu
AKQ	PG	L	Ak
AKR	VU	L	Araki
AKS	TG	L	Akaselem
AKT	PG	L	Akolet
AKU	CM	L	Akum
AKV	RU	L	Akhvakh
AKW	CG	L	Akwa
AKX	IN	E	Aka-kede
AKY	IN	E	Aka-kol
AKZ	US	L	Alabama
ALA	NG	L	Alago
ALB	ET	L	Alaba
ALC	CL	L	Qawasqar
ALD	CI	L	Alladian
ALE	US	E	Atakapa
ALF	NG	L	Alege
ALG	CA	L	Algonquin
ALH	AU	N	Alawa
ALI	PG	L	Amaimon
ALJ	PH	L	Alangan
ALK	LA	L	Alak
ALL	IN	L	Allar
ALM	VU	L	Amblong
ALN	AL	L	Albanian, Tosk
ALO	ID	L	Larike-wakasihu
ALP	ID	L	Alune
ALR	RU	L	Alutor
ALS	YU	L	Albanian, Gheg
ALT	RU	L	Altai, Southern
ALU	SB	L	'Are'are
ALV	TW	L	Amis
ALW	US	L	Aleut
ALX	PG	L	Alatil
ALY	AU	L	Alyawarr
ALZ	ZR	L	Alur
AMA	BR	L	Amanayé
AMB	NG	L	Ambo
AMC	PE	L	Amahuaca
AMD	BR	L	Amapá Creole
AME	PE	L	Yanesha'
AMF	ET	L	Hamer-banna
AMG	AU	N	Amarag
AMH	ET	L	Amharic
AMI	PG	L	Amele
AMJ	TD	L	Amdang
AMK	ID	L	Ambai
AML	IN	L	Amwi
AMM	PG	L	Ama
AMN	PG	L	Amanab
AMO	NG	L	Amo
AMP	PG	L	Alamblak
AMQ	ID	N	Amahai
AMR	PE	L	Amarakaeri
AMS	JP	L	Amami-oshima, Southern
AMT	PG	L	Amto
AMU	MX	L	Amuzgo, Guerrero
AMV	ID	L	Ambelau
AMW	SY	L	Western Neo-aramaic
AMX	AU	L	Anmatyerre
AMY	AU	L	Ami
AMZ	AU	N	Atampaya
ANA	CO	E	Andaqui
ANB	PE	E	Andoa
ANC	NG	L	Ngas
AND	ID	L	Ansus
ANE	NC	L	Xârâcùù
ANF	GH	L	Animere
ANG	CN	L	Kon Keu
ANH	PG	L	Nend
ANI	RU	L	Andi
ANJ	PG	L	Anor
ANK	NG	L	Goemai
ANL	MM	L	Anu
ANM	IN	L	Anal
ANN	NG	L	Obolo
ANO	CO	L	Andoque
ANP	IN	L	Angika
ANQ	IN	L	Jarawa
ANR	IN	L	Andh
ANS	CO	E	Anserma
ANT	AU	L	Antakarinya
ANU	SD	L	Anuak
ANV	CM	L	Denya
ANW	NG	L	Anaang
ANX	PG	L	Andra-hus
ANY	CI	L	Anyin
ANZ	PG	L	Anem
AOA	ST	L	Angolar
AOC	VE	L	Pemon
AOD	PG	L	Andarum
AOE	PG	L	Angal Enen
AOF	PG	L	Bragat
AOG	PG	L	Angoram
AOH	CO	E	Arma
AOI	AU	L	Anindilyakwa
AOJ	PG	L	Mufian
AOK	NC	L	Arhö
AOL	ID	L	Alor
AOM	PG	L	ömie
AON	PG	L	Arapesh, Bumbita
AOR	VU	N	Aore
AOS	ID	L	Taikat
AOT	IN	L	A'tong
APA	BR	L	Apalaí
APB	SB	L	Sa'a
APC	SY	L	Arabic, North Levantine Spoken
APD	SD	L	Arabic, Sudanese Spoken
APE	PG	L	Bukiyip
APG	ID	L	Ampanang
APH	NP	L	Athpariya
API	BR	L	Apiacá
APJ	US	L	Apache, Jicarilla
APK	US	N	Apache, Kiowa
APL	US	N	Apache, Lipan
APM	US	L	Apache, Mescalero-chiricahua
APN	BR	L	Apinayé
APO	PG	L	Apos
APP	VU	L	Apma
APQ	IN	N	A-pucikwar
APR	PG	L	Arop-lokep
APS	PG	L	Arop-sissano
APT	IN	L	Apatani
APU	BR	L	Apurinã
APW	US	L	Apache, Western
APX	ID	L	Aputai
APZ	PG	L	Ampeeli-wojokeso
AQM	ID	L	Atohwaim
AQN	PH	L	Alta, Northern
ARA	BR	E	Arua
ARB	GY	L	Akawaio
ARC	RU	L	Archi
ARD	AU	N	Arabana
ARE	AU	L	Arrarnta, Western
ARF	PG	L	Arafundi
ARG	NC	L	Xaragure
ARH	CO	L	Ica
ARI	US	L	Arikara
ARJ	BR	L	Arapaso
ARK	BR	N	Arikapú
ARL	PE	L	Arabela
ARM	AM	L	Armenian
ARN	NC	L	Arhâ
ARO	BO	L	Araona
ARP	US	L	Arapaho
ARQ	DZ	L	Arabic, Algerian Spoken
ARR	BR	L	Arára, Rondônia
ARS	SA	L	Arabic, Najdi Spoken
ART	BR	L	Rikbaktsa
ARU	CL	L	Mapudungun
ARV	ET	L	Arbore
ARW	SR	L	Arawak
ARX	BR	N	Aruá
ARY	MA	L	Arabic, Moroccan Spoken
ARZ	EG	L	Arabic, Egyptian Spoken
ASA	TZ	L	Asu
ASB	CA	L	Assiniboine
ASC	ID	L	Asmat, Casuarina Coast
ASD	PG	L	Asas
ASE	US	L	American Sign Language
ASF	AU	L	Australian Sign Language
ASG	NG	L	Cishingini
ASH	PE	E	Abishira
ASI	ID	L	Buruwai
ASJ	CM	L	Nsari
ASK	AF	L	Ashkun
ASL	ID	L	Asilulu
ASM	IN	L	Assamese
ASN	BR	L	Asuriní, Xingú
ASO	PG	L	Dano
ASP	DZ	L	Algerian Sign Language
ASQ	AT	L	Austrian Sign Language
ASR	IN	L	Asuri
ASS	CM	L	Ipulo
AST	ID	L	Asmat, Central
ASU	BR	L	Asuriní
ASV	ZR	L	Asoa
ASW	AU	L	Australian Aborigines Sign Language
ASX	PG	L	Asat
ASY	ID	L	Asmat, Yaosakor
ASZ	ID	L	As
ATA	PG	L	Pele-ata
ATB	CN	L	Zaiwa
ATC	PE	E	Atsahuaca
ATD	PH	L	Manobo, Ata
ATE	PG	L	Atemble
ATF	CN	L	Atuence
ATG	NG	L	Ivbie North-okpela-arhe
ATH	PH	L	Atta, Faire
ATI	CI	L	Attié
ATJ	ID	L	Aceh
ATK	PH	L	Ati
ATL	PH	L	Agta, Mt. Iraya
ATM	PH	N	Ata
ATN	IR	L	Ashtiani
ATO	CM	L	Atong
ATP	PH	L	Atta, Pudtol
ATQ	ID	L	Aralle-tabulahan
ATR	BR	L	Atruahí
ATS	US	N	Gros Ventre
ATT	PH	L	Atta, Pamplona
ATU	SD	L	Reel
ATV	RU	L	Altai, Northern
ATW	US	N	Atsugewi
ATX	BR	N	Arutani
ATY	VU	L	Aneityum
ATZ	PH	L	Arta
AUA	SB	L	Asumboa
AUB	ES	L	Asturian
AUC	EC	L	Waorani
AUD	SB	L	Anuta
AUE	NA	L	=/Kx'au//'ein
AUG	BJ	L	Aguna
AUH	ZM	L	Aushi
AUI	PG	L	Anuki
AUJ	LY	L	Awjilah
AUK	PG	L	Wanib
AUL	VU	L	Aulua
AUM	NG	L	Asu
AUN	PG	L	Aunalei
AUO	NG	E	Auyokawa
AUP	PG	L	Aturu
AUQ	ID	L	Anus
AUR	PG	L	Aruek
AUS	PE	E	Aushiri
AUT	PF	L	Austral
AUU	ID	L	Auye
AUV	FR	L	Auvergnat
AUW	ID	L	Awyi
AUY	PG	L	Awiyaana
AUZ	UZ	L	Arabic, Uzbeki Spoken
AVA	GH	L	Avatime
AVB	PG	L	Avau
AVD	IR	L	Alviri-vidari
AVE	NC	L	Haveke
AVI	CI	L	Avikam
AVL	EG	L	Arabic, Eastern Egyptian Bedawi Spoken
AVO	BR	L	Agavotaguerra
AVR	RU	L	Avar
AVS	IR	E	Avestan
AVT	PG	L	Au
AVU	ZR	L	Avokaya
AVV	BR	L	Avá-canoeiro
AWA	NG	L	Acipa, Eastern
AWB	PG	L	Awa
AWC	NG	L	Acipa, Western
AWD	IN	L	Awadhi
AWE	BR	L	Awetí
AWG	AU	E	Agwamin
AWH	ID	L	Awbono
AWI	PG	L	Aekyom
AWJ	ID	L	Awyu, Nohon
AWK	AU	E	Awabakal
AWM	PG	L	Arawum
AWN	ET	L	Awngi
AWO	NG	L	Awak
AWR	ID	L	Awera
AWT	BR	L	Araweté
AWW	PG	L	Awun
AWX	PG	L	Awara
AXA	BR	L	Arára, Acre
AXG	BR	E	Arára, Mato Grosso
AXK	CF	L	Yaka
AXX	ES	L	Aragonese
AYA	PG	L	Awar
AYB	BJ	L	Ayizo-gbe
AYC	PE	L	Aymara, Southern
AYD	AU	N	Ayabadhu
AYE	NG	L	Ayere
AYG	TG	L	Anyanga
AYH	YE	L	Arabic, Hadrami Spoken
AYI	NG	L	Leyigha
AYL	LY	L	Arabic, Libyan Spoken
AYM	BO	L	Aymara, Central
AYN	YE	L	Arabic, Sanaani Spoken
AYO	PY	L	Ayoreo
AYP	IQ	L	Arabic, North Mesopotamian Spoken
AYS	PH	N	Ayta, Sorsogon
AYT	PH	L	Ayta, Bataan
AYU	NG	L	Ayu
AYX	CN	L	Ayi
AYY	PH	E	Ayta, Tayabas
AYZ	ID	L	Mai Brat
AZB	IR	L	Azerbaijani, South
AZE	AZ	L	Azerbaijani, North
AZG	MX	L	Amuzgo, San Pedro Amuzgos
AZM	MX	L	Amuzgo, Ipalapa
AZO	CM	L	Awing
AZR	PG	L	Adzera
AZZ	MX	L	Náhuatl, Puebla, Sierra
BAA	CM	L	Basaa
BAB	GW	L	Bainouk-gunyuño
BAC	ID	L	Badui
BAD	ID	L	Eritai
BAE	VE	N	Baré
BAF	CM	L	Nubaca
BAG	CM	L	Tuki
BAH	BS	L	Bahamas Creole English
BAI	BR	L	Baniwa
BAJ	ID	L	Barakai
BAK	CI	L	Bakwé
BAL	SG	L	Malay, Baba
BAM	NG	L	Bacama
BAN	CM	L	Yemba
BAO	CO	L	Waimaha
BAP	NP	L	Bantawa
BAQ	SB	L	Babatana
BAR	AT	L	Bavarian
BAS	LR	L	Bassa
BAT	ID	L	Bekati'
BAU	NG	L	Bada
BAV	CM	L	Vengo
BAW	CM	L	Bambili
BAX	CM	L	Bamun
BAY	ID	L	Batuley
BAZ	CM	L	Tunen
BBA	BJ	L	Bariba
BBB	PG	L	Baruga
BBC	ID	L	Batak Toba
BBD	PG	L	Bau
BBE	ZR	L	Bangba
BBF	PG	L	Baibai
BBG	GA	L	Barama
BBH	CN	L	Bugan
BBI	CM	L	Barombi
BBJ	CM	L	Ghomálá'
BBK	CM	L	Babanki
BBL	GE	L	Bats
BBM	ZR	L	Babango
BBN	PG	L	Uneapa
BBO	BF	L	Bobo Madaré, Northern
BBP	CF	L	Banda, West Central
BBQ	CM	L	Bamali
BBR	PG	L	Girawa
BBS	NG	L	Bakpinka
BBT	NG	L	Mburku
BBU	NG	L	Kulung
BBV	PG	L	Barim
BBW	CM	L	Baba
BBX	CM	L	Bubia
BBY	CM	L	Befang
BBZ	TD	L	Arabic, Babalia Creole
BCA	PG	L	Barai
BCB	SN	L	Bainouk-samik
BCC	PK	L	Balochi, Southern
BCD	ID	L	Babar, North
BCE	CM	L	Bamenyam
BCF	PG	L	Bamu
BCG	GN	L	Baga Binari
BCH	PG	L	Bariai
BCI	CI	L	Baoulé
BCJ	AU	N	Baadi
BCK	AU	L	Bunaba
BCL	PG	L	Psohoh
BCM	PG	L	Banoni
BCN	NG	L	Bali
BCO	PG	L	Kaluli
BCP	ZR	L	Bali
BCQ	ET	L	Bench
BCR	CA	L	Babine
BCS	NG	L	Kohumono
BCT	ZR	L	Bendi
BCU	PG	L	Awad Bing
BCV	NG	L	Shoo-minda-nye
BCW	CM	L	Bana
BCX	ID	L	Pamona
BCY	VU	L	Bislama
BCZ	SN	L	Bainouk-gunyaamolo
BDA	SN	L	Bayot
BDB	ID	L	Basap
BDC	CO	L	Emberá-baudó
BDD	PG	L	Bunama
BDE	NG	L	Bade
BDF	IQ	L	Behdini
BDG	MY	L	Bonggi
BDH	SD	L	Baka
BDI	SD	L	Burun
BDJ	SD	L	Bai
BDK	AZ	L	Budukh
BDL	ID	L	Bajau, Indonesian
BDM	TD	L	Buduma
BDN	CM	L	Baldamu
BDO	TD	L	Bernde
BDP	TZ	L	Bende
BDQ	VN	L	Bahnar
BDR	MY	L	Bajau, West Coast
BDS	TZ	L	Burunge
BDT	CF	L	Bokoto
BDU	CM	L	Bakundu-balue
BDV	IN	L	Bodo Parja
BDW	ID	L	Baham
BDX	ID	L	Biksi
BDY	AU	L	Bandjalang
BDZ	PK	L	Badeshi
BEA	CA	L	Beaver
BEB	CM	L	Bebele
BEC	CM	L	Iceve-maci
BED	ID	L	Bedoanas
BEE	IN	L	Byangsi
BEF	PG	L	Benabena
BEG	BN	L	Belait
BEH	BJ	L	Biali
BEI	SD	L	Bedawi
BEJ	CG	L	Beembe
BEK	PG	L	Bebeli
BEL	CA	L	Bella Coola
BEM	ZM	L	Bemba
BEN	GQ	L	Benga
BEO	PG	L	Beami
BEP	ID	L	Besoa
BEQ	CN	L	Bela
BER	ID	L	Berik
BES	TD	L	Besme
BET	CI	L	Béte, Guiberoua
BEU	ID	L	Blagar
BEV	CI	L	Bété, Daloa
BEW	ID	L	Betawi
BEX	SD	L	Jur Modo
BEY	PG	L	Beli
BEZ	TZ	L	Bena
BFA	SD	L	Bari
BFD	CM	L	Bafut
BFE	ID	L	Betaf
BFF	CF	L	Bofi
BFG	ID	L	Kayan, Busang
BFJ	CM	L	Bafanji
BFL	CF	L	Banda-ndélé
BFM	CM	L	Mmen
BFO	BF	L	Birifor, Malba
BFQ	IN	L	Badaga
BFR	IN	L	Bazigar
BFS	IN	L	Braj Bhasha
BFT	PK	L	Balti
BFU	IN	L	Gahri
BFW	IN	L	Bondo
BFY	IN	L	Bagheli
BFZ	IN	L	Pahari, Mahasu
BGA	NG	L	Gwamhi-wuri
BGC	IN	L	Haryanvi
BGD	IN	L	Bareli
BGE	IN	L	Bauria
BGF	CM	L	Bangandu
BGI	PH	L	Giangan
BGJ	CM	L	Bangolan
BGK	LA	L	Bit
BGL	LA	L	Bo
BGM	GN	N	Baga Mboteni
BGN	PK	L	Balochi, Western
BGO	GN	N	Baga Koga
BGP	PK	L	Balochi, Eastern
BGQ	IN	L	Bagri
BGR	IN	L	Chin, Bawm
BGS	PH	L	Manobo, Tagabawa
BGT	SB	L	Bughotu
BGU	NG	L	Mbongno
BGV	ID	L	Warkay-bipim
BGW	IN	L	Bhatri
BGX	TR	L	Balkan Gagauz Turkish
BGY	ID	L	Benggoi
BGZ	ID	L	Banggai
BHA	IN	L	Bharia
BHB	IN	L	Bhili
BHD	IN	L	Bhadrawahi
BHE	PK	L	Bhaya
BHF	PG	L	Busa
BHG	PG	L	Binandere
BHH	IL	L	Bukharic
BHI	IN	L	Bhilali
BHJ	IN	L	Bhojpuri
BHK	PH	L	Bicolano, Albay
BHL	PG	L	Bimin
BHN	GE	L	Bohtan Neo-aramaic
BHO	GB	L	British Sign Language
BHP	ID	L	Bima
BHQ	ID	L	Tukangbesi South
BHS	CM	L	Buwal
BHT	IN	L	Bhattiyali
BHU	IN	L	Bhunjia
BHV	ID	L	Bahau
BHW	ID	L	Biak
BHX	IN	L	Bhalay
BHZ	ID	L	Bada
BIA	AU	N	Badimaya
BIB	BF	L	Bissa
BIC	PG	L	Bikaru
BID	TD	L	Bidiyo
BIE	PG	L	Bepour
BIF	GW	L	Biafada
BIG	PG	L	Biangai
BIH	TD	L	Bideyat
BII	CN	L	Bisu
BIJ	NG	L	Vaghat-ya-bijim-legeri
BIK	PH	L	Blaan, Koronadal
BIL	NG	L	Bile
BIM	GH	L	Bimoba
BIN	ZR	L	Binji
BIO	PG	L	Nai
BIP	ZR	L	Bila
BIQ	PG	L	Bipi
BIR	PG	L	Bisorio
BIS	PH	L	Blaan, Sarangani
BIT	PG	L	Bitara
BIU	IN	L	Biete
BIV	GH	L	Birifor, Southern
BIW	CM	L	Kol
BIX	IN	L	Bijori
BIY	IN	L	Birhor
BIZ	ZR	L	Baloi
BJA	ZR	L	Budza
BJB	AU	E	Banggarla
BJC	PG	L	Bariji
BJD	AU	N	Bandjigali
BJE	CN	L	Biao-jiao Mien
BJF	IL	E	Bijil Neo-aramaic
BJG	GW	L	Bidyogo
BJH	PG	L	Bahinemo
BJI	ET	L	Burji
BJJ	IN	L	Kanauji
BJK	PG	L	Barok
BJL	PG	L	Bulu
BJM	IQ	L	Bajelan
BJN	ID	L	Banjar
BJO	CF	L	Banda, Mid-southern
BJR	PG	L	Binumarien
BJS	BB	L	Bajan
BJT	SN	L	Balanta-ganja
BJU	CM	N	Busuu
BJY	AU	E	Bayali
BKA	NG	L	Kyak
BKB	PH	L	Bontoc, Eastern
BKC	CM	L	Baka
BKD	PH	L	Binukid
BKE	ID	L	Bengkulu
BKF	ZR	L	Beeke
BKG	CF	L	Buraka
BKH	CM	L	Bakoko
BKI	VU	L	Baki
BKJ	CF	L	Pande
BKK	IN	L	Brokskat
BKL	PH	L	Bicolano, Central
BKM	CM	L	Kom
BKN	MY	L	Bukitan
BKO	CM	L	Kwa'
BKP	ZR	L	Boko
BKQ	BR	L	Bakairí
BKR	ID	L	Bakumpai
BKS	PH	L	Sorsogon, Masbate
BKT	ZR	L	Boloki
BKU	PH	L	Buhid
BKV	NG	L	Bekwarra
BKW	CG	L	Bekwel
BKY	NG	L	Bokyi
BKZ	ID	L	Bungku
BLA	TH	L	Ban Khor Sign Language
BLB	SB	L	Bilua
BLC	CA	L	Blackfoot
BLD	ID	L	Bolango
BLE	GW	L	Balanta-kentohe
BLF	ID	L	Buol
BLG	BG	L	Bulgarian
BLH	LR	L	Kuwaa
BLI	ZR	L	Bolia
BLJ	ID	L	Bolongan
BLK	MM	L	Karen, Pa'o
BLL	US	E	Biloxi
BLM	SD	L	Beli
BLN	PH	L	Bicolano, Southern Catanduanes
BLO	BJ	L	Anii
BLP	SB	L	Blablanga
BLQ	PG	L	Baluan-pam
BLR	CN	L	Blang
BLS	ID	L	Balaesan
BLT	VN	L	Tai Dam
BLU	CN	L	Hmong Njua
BLV	AO	L	Bolo
BLW	PH	L	Balangao
BLX	PH	L	Ayta, Mag-indi
BLY	BJ	L	Boulba
BLZ	ID	L	Balantak
BMA	NG	L	Lame
BMB	ZR	L	Bembe
BMC	PG	L	Biem
BMD	GN	L	Baga Manduri
BME	ZR	L	Bomassa
BMF	SL	L	Bom
BMG	ZR	L	Bamwe
BMH	PG	L	Bemal
BMI	TD	L	Bagirmi
BMJ	NP	L	Bote-majhi
BMK	PG	L	Ghayavi
BML	ZR	L	Bomboli
BMN	PG	E	Bina
BMO	CM	L	Bambalang
BMP	PG	L	Bulgebi
BMQ	ML	L	Bomu
BMR	CO	L	Muinane
BMS	MM	L	Burmese
BMT	CN	L	Biao Mien
BMU	PG	L	Burum-mindik
BMV	CM	L	Bum
BMW	CG	L	Bomwali
BMX	PG	L	Baimak
BMY	ZR	L	Bemba
BMZ	PG	L	Baramu
BNA	ID	L	Bonerate
BNB	MY	L	Baukan
BNC	PH	L	Bontoc, Central
BND	ID	L	Banda
BNE	ID	L	Bintauna
BNF	ID	L	Masiwang
BNG	BD	L	Bengali
BNH	BR	L	Banawá
BNI	ZR	L	Bangi
BNJ	PH	L	Tawbuid, Eastern
BNK	VU	L	Bierebo
BNL	SO	N	Boon
BNM	GQ	L	Batanga
BNN	TW	L	Bunun
BNO	PH	L	Bantoanon
BNP	PG	L	Bola
BNQ	ID	L	Bantik
BNR	VU	L	Butmas-tur
BNS	IN	L	Bundeli
BNT	SB	L	Baniata
BNU	ID	L	Bentong
BNV	ID	N	Bonerif
BNW	PG	L	Bisis
BNX	ZR	L	Bangubangu
BNY	MY	L	Bintulu
BNZ	CM	L	Beezen
BOA	PE	L	Bora
BOB	KE	L	Boni
BOC	ID	L	Kenyah, Bakung
BOD	NG	L	Boga
BOE	CM	L	Bu
BOF	BF	L	Bolon
BOG	ML	L	Bamako Sign Language
BOH	ZR	L	Boma
BOI	US	E	Barbareño
BOJ	PG	L	Anjam
BOK	CG	L	Bonjo
BOL	NG	L	Bole
BOM	NG	L	Berom
BON	NP	L	Baragaunle
BOO	ML	L	Bozo, Tièma Cièwè
BOP	PG	L	Bonkiman
BOQ	PG	L	Bogaya
BOR	BR	L	Borôro
BOS	PG	L	Bosilewa
BOT	SD	L	Bongo
BOU	TZ	L	Bondei
BOV	GH	L	Tuwili
BOW	PG	L	Rema
BOX	BF	L	Bwamu
BOY	CF	N	Bodo
BOZ	ML	L	Bozo, Tiéyaxo
BPA	VU	L	Dakaka
BPB	CO	E	Barbacoas
BPD	CF	L	Banda-banda
BPG	ID	L	Bonggo
BPH	RU	L	Botlikh
BPI	PG	L	Bagupi
BPK	NC	L	Orowe
BPL	AU	L	Broome Pearling Lugger Pidgin
BPM	PG	L	Biyom
BPN	CN	L	Ba Pai
BPO	ID	L	Anasi
BPP	ID	L	Kaure
BPR	ID	L	Bugis
BPT	AU	N	Barrow Point
BPU	PG	L	Bongu
BPV	ID	L	Marind, Bian
BPW	PG	L	Bo
BPY	IN	L	Bishnupriya
BQA	BJ	L	Basa
BQB	ID	L	Bagusa
BQC	BJ	L	Boko
BQD	CM	N	Bung
BQE	FR	L	Basque, Navarro-labourdin
BQF	GN	E	Baga Kaloum
BQG	TG	L	Bago
BQH	CN	L	Baima
BQI	IN	L	Bhilori
BQJ	SN	L	Bandial
BQK	CF	L	Banda-mbrès
BQL	PG	N	Bilakura
BQM	CM	L	Wumboko
BQN	BG	L	Bulgarian Sign Language
BQO	CM	L	Balo
BQP	NG	L	Busa
BQQ	ID	L	Biritai
BQR	ID	L	Burusu
BQS	PG	L	Bosngun
BQT	CM	L	Bamukumbit
BQU	SD	L	Boguru
BQV	NG	L	Begbere-ejar
BQW	NG	L	Buru
BQX	NG	L	Baangi
BQY	ID	L	Bali Sign Language
BQZ	CM	L	Bakaka
BRA	ML	L	Bamanankan
BRB	LA	L	Lave
BRC	GY	N	Berbice Creole Dutch
BRD	NP	L	Baraamu
BRE	NG	L	Bitare
BRF	ZR	L	Bera
BRG	BO	N	Baure
BRH	PK	L	Brahui
BRI	CM	L	Mokpwe
BRJ	VU	L	Bieria
BRK	SD	E	Birked
BRL	BW	L	Birwa
BRM	ZR	L	Barambu
BRN	CR	N	Boruca
BRO	BT	L	Brokkat
BRP	ID	L	Barapasi
BRQ	PG	L	Breri
BRR	SB	L	Birao
BRS	ID	L	Baras
BRT	FR	L	Breton
BRU	LA	L	Bru, Eastern
BRV	TH	L	Bru, Western
BRW	IN	L	Bellari
BRX	IN	L	Bodo
BRY	PG	L	Burui
BRZ	PG	L	Bilbil
BSA	ID	L	Abinomn
BSB	BN	L	Bisaya, Brunei
BSC	SN	L	Basari
BSD	MY	L	Bisaya, Sarawak
BSE	CM	L	Wushi
BSF	NG	L	Bauchi
BSG	IR	L	Bashkardi
BSH	AF	L	Kati
BSI	CM	L	Bassossi
BSJ	NG	L	Bangwinji
BSK	PK	L	Burushaski
BSL	NG	E	Basa-gumna
BSM	ID	L	Busami
BSN	CO	L	Barasana
BSO	TD	N	Buso
BSP	GN	L	Baga Sitemu
BSQ	ES	L	Basque
BSR	NG	N	Bassa-kontagora
BSS	CM	L	Akoose
BST	ET	L	Basketto
BSU	ID	L	Bahonsuai
BSV	GN	E	Baga Sobané
BSW	ET	L	Baiso
BSX	NG	L	Yangkam
BSY	MY	L	Bisaya, Sabah
BSZ	FR	L	Basque, Souletin
BTA	NG	L	Bata
BTB	CM	L	Beti
BTC	CM	L	Bati
BTD	ID	L	Batak Dairi
BTE	NG	E	Gamo-ningi
BTF	TD	L	Birgit
BTG	CI	L	Bété, Gagnoa
BTH	MY	L	Biatah
BTI	ID	L	Burate
BTJ	ID	L	Malay, Bacanese
BTK	PH	L	Batak
BTL	IN	L	Bhatola
BTM	ID	L	Batak Mandailing
BTN	PH	L	Ratagnon
BTO	PH	L	Bicolano, Iriga
BTP	PG	L	Budibud
BTQ	MY	L	Batek
BTR	VU	L	Baetora
BTS	ID	L	Batak Simalungun
BTT	NG	L	Bete-bendi
BTU	NG	L	Batu
BTV	PK	L	Bateri
BTW	PH	L	Butuanon
BTX	ID	L	Batak Karo
BTY	ID	L	Bobot
BTZ	ID	L	Batak Alas-kluet
BUA	TP	L	Bunak
BUB	TD	L	Bua
BUC	MG	L	Bushi
BUD	TG	L	Ntcham
BUE	CA	E	Beothuk
BUF	ZR	L	Bushoong
BUG	MY	L	Balau
BUH	CN	L	Bunu, Younuo
BUI	CG	L	Bongili
BUJ	NG	L	Basa-gurmana
BUK	PG	L	Bugawac
BUL	KE	L	Bukusu
BUM	CM	L	Bulu
BUN	SL	L	Sherbro
BUO	PG	L	Buin
BUP	ID	L	Busoa
BUQ	PG	L	Brem
BUR	NG	L	Bura-pabir
BUS	NG	L	Bokobaru
BUT	PG	L	Bungain
BUU	ZR	L	Budu
BUV	PG	L	Bun
BUW	GA	L	Bubi
BUX	NG	L	Boghom
BUY	SL	N	Bullom So
BUZ	NG	L	Bukwen
BVA	TD	L	Barein
BVB	GQ	L	Bube
BVC	SB	L	Baelelea
BVD	SB	L	Baeggu
BVE	ID	L	Malay, Berau
BVF	TD	L	Boor
BVG	CM	L	Bonkeng
BVH	NG	L	Bure
BVI	SD	L	Belanda Viri
BVJ	NG	L	Baan
BVK	ID	L	Bukat
BVL	BO	L	Bolivian Sign Language
BVN	PG	L	Buna
BVO	TD	L	Bolgo
BVQ	CF	L	Birri
BVR	AU	L	Burarra
BVS	BE	L	Belgian Sign Language
BVT	ID	L	Bati
BVU	ID	L	Malay, Bukit
BVV	VE	E	Baniva
BVX	CG	L	Babole
BWA	NC	L	Bwatoo
BWB	FJ	L	Namosi-naitasiri-serua
BWC	ZM	L	Bwile
BWD	PG	L	Bwaidoka
BWE	MM	L	Karen, Bwe
BWG	MZ	L	Barwe
BWH	CM	N	Bishuo
BWJ	BF	L	Bwamu, Láá Láá
BWK	PG	L	Bauwaki
BWL	ZR	L	Bwela
BWM	PG	L	Biwat
BWN	CN	L	Bunu, Wunai
BWO	ET	L	Boro
BWQ	BF	L	Bobo Madaré, Southern
BWS	ZR	L	Bomboma
BWT	CM	L	Bafaw-balong
BWU	GH	L	Buli
BWV	ID	L	Kenyah, Bahau River
BWW	ZR	L	Bwa
BWX	CN	L	Bunu, Bu-nao
BWY	BF	L	Bwamu, Cwi
BWZ	CG	L	Bwisi
BXA	SB	L	Bauro
BXB	SD	L	Belanda Bor
BXC	GQ	L	Molengue
BXE	ET	N	Birale
BXF	PG	L	Bilur
BXG	ZR	L	Bangala
BXH	PG	L	Buhutu
BXI	AU	E	Pirlatapa
BXJ	AU	N	Bayungu
BXK	RU	L	Bashkir
BXL	BF	L	Blé
BXM	MN	L	Buriat, Mongolia
BXN	AU	N	Burduna
BXO	NG	L	Barikanchi
BXP	CM	L	Bebil
BXQ	NG	L	Beele
BXR	IN	L	Purik
BXS	CM	L	Busam
BXT	CN	L	Buxinhua
BXU	CN	L	Buriat, China
BXV	TD	N	Berakou
BXW	ML	L	Bankagoma
BXX	ZR	L	Borna
BXY	PG	L	Bongos
BXZ	PG	L	Binahari
BYA	IL	E	Babylonian Talmudic Aramaic
BYB	CM	N	Bikya
BYC	NG	L	Ubaghara
BYD	ID	L	Benyadu'
BYE	PG	L	Pouye
BYF	NG	N	Bete
BYG	SD	E	Baygo
BYH	HN	L	Bay Islands Creole English
BYI	ZR	L	Buyu
BYJ	NG	L	Bina
BYL	ID	L	Bayono
BYM	AU	N	Bidyara
BYN	ER	L	Bilen
BYO	CN	L	Biyo
BYP	NG	L	Bumaji
BYQ	TW	E	Basay
BYR	PG	L	Baruya
BYS	NG	L	Burak
BYT	SD	E	Berti
BYU	CN	L	Buyang
BYV	CM	L	Medumba
BYW	NP	L	Belhariya
BYX	PG	L	Qaqet
BYY	ZR	L	Buya
BYZ	PG	L	Banaro
BZB	ID	L	Andio
BZC	ID	L	Bali
BZD	CR	L	Bribri
BZE	ML	L	Bozo, Sorogama
BZF	PG	L	Boikin
BZG	TW	N	Babuza
BZH	PG	L	Buang, Mapos
BZI	BZ	L	Northern Central America Creole English
BZL	ID	L	Bolano
BZM	ZR	L	Bolondo
BZN	ID	L	Boano
BZO	ZR	L	Bozaba
BZP	ID	L	Kemberano
BZQ	ID	L	Buli
BZR	AU	N	Biri
BZS	BR	L	Brazilian Sign Language
BZU	ID	L	Burmeso
BZV	CM	L	Bebe
BZW	NG	L	Basa
BZX	ML	L	Bozo, Hainyaxo
BZY	NG	L	Obanliku
BZZ	NG	L	Evant
CAA	GT	L	Chortí
CAB	HN	L	Garífuna
CAC	GT	L	Chuj, San Sebastián Coatán
CAD	US	L	Caddo
CAE	SN	L	Lehar
CAF	CA	L	Carrier, Southern
CAG	PY	L	Chulupí
CAH	PE	N	Cahuarano
CAI	DM	E	Carib, Island
CAJ	AR	E	Chané
CAK	GT	L	Cakchiquel, Central
CAL	MP	L	Carolinian
CAM	NC	L	Cemuhî
CAN	PG	L	Chambri
CAO	BO	L	Chácobo
CAP	BO	L	Chipaya
CAQ	IN	L	Nicobarese, Car
CAR	CA	L	Carrier
CAS	BO	L	Tsimané
CAT	BO	E	Cayubaba
CAU	PH	L	Caluyanun
CAV	BO	L	Cavineña
CAW	BO	L	Callawalla
CAX	BO	L	Chiquitano
CAY	CA	L	Cayuga
CAZ	BO	E	Canichana
CBB	CO	N	Cabiyarí
CBC	CO	L	Carapana
CBD	CO	L	Carijona
CBE	CO	E	Chipiajes
CBF	CO	E	Chibcha
CBG	CO	L	Chimila
CBH	CO	E	Cagua
CBI	EC	L	Chachi
CBJ	BJ	L	Cabe
CBK	PH	L	Chavacano
CBM	GT	L	Cakchiquel, Southwestern, Yepocapa
CBN	TH	L	Nyahkur
CBO	NG	L	Izora
CBR	PE	L	Cashibo-cacataibo
CBS	PE	L	Cashinahua
CBT	PE	L	Chayahuita
CBU	PE	L	Candoshi-shapra
CBV	CO	L	Cacua
CBY	CO	L	Carabayo
CCC	PE	N	Chamicuro
CCD	BR	L	Cafundo Creole
CCE	MZ	L	Chopi
CCG	NG	L	Samba Daka
CCH	NG	L	Atsam
CCJ	GW	L	Kasanga
CCL	KE	L	Cutchi-swahili
CCM	MY	L	Malaccan Creole Malay
CCO	MX	L	Chinanteco, Comaltepec
CCP	IN	L	Chakma
CCQ	MM	L	Chaungtha
CCR	SV	E	Cacaopera
CCT	US	L	Choctaw
CCX	CN	L	Zhuang, Northern
CCY	CN	L	Zhuang, Southern
CDA	CN	L	Choni
CDE	IN	L	Chenchu
CDF	IN	L	Chiru
CDG	IN	L	Chamari
CDH	IN	L	Chambeali
CDI	IN	L	Chodri
CDJ	IN	L	Churahi
CDM	NP	L	Chepang
CDN	IN	L	Chaudangsi
CDO	CN	L	Chinese, Min Dong
CDS	TD	L	Chadian Sign Language
CEA	US	N	Chehalis, Lower
CEB	PH	L	Cebuano
CEG	PY	L	Chamacoco
CEN	BJ	L	Cenka
CER	US	L	Cherokee
CET	NG	L	Centúúm
CFA	NG	L	Dijim-bwilim
CFD	NG	L	Cara
CFG	NG	L	Como Karim
CFR	CN	L	Chinese, Min Nan
CGA	PG	L	Changriwa
CGC	PH	L	Kagayanen
CGP	MM	L	Jingpho
CGT	TM	E	Chagatai
CHA	GH	L	Chala
CHB	DZ	L	Chenoua
CHC	US	N	Catawba
CHD	MX	L	Chontal De Oaxaca, Sierra
CHE	US	N	Chetco
CHF	MX	L	Chontal, Tabasco
CHG	UG	L	Chiga
CHH	US	N	Chinook
CHI	CA	L	Chilcotin
CHJ	MX	L	Chinanteco, Ojitlán
CHK	BT	L	Chocangacakha
CHL	US	N	Cahuilla
CHM	US	E	Chitimacha
CHN	CN	L	Chinese, Mandarin
CHO	IN	L	Chaura
CHP	NG	L	Miship
CHQ	MX	L	Chinanteco, Quiotepec
CHR	VN	L	Chrau
CHS	US	E	Chumash
CHT	PE	N	Cholon
CHU	RU	L	Chulym
CHV	MX	L	Chinanteco, Valle Nacional
CHW	MZ	L	Chuwabo
CHX	NP	L	Chantyal
CHY	US	L	Cheyenne
CHZ	MX	L	Chinanteco, Ozumacín
CIA	ID	L	Cia-cia
CIB	BJ	L	Ci-gbe
CIC	US	L	Chickasaw
CID	US	E	Chimariko
CIE	NG	L	Cineni
CIH	IN	L	Chinali
CIK	IN	L	Kinnauri, Chitkuli
CIM	IT	L	Cimbrian
CIN	BR	L	Cinta Larga
CIP	MX	N	Chiapaneco
CIR	NC	L	Tiri
CIT	BD	L	Chittagonian
CIW	US	L	Chippewa
CJA	KH	L	Cham, Western
CJC	RU	L	Chechen
CJD	GU	L	Chamorro
CJE	VN	L	Chru
CJH	US	N	Chehalis, Upper
CJI	RU	L	Chamalal
CJK	ZR	L	Chokwe
CJM	VN	L	Cham, Eastern
CJN	PG	L	Chenapian
CJO	PE	L	Ashéninca Pajonal
CJP	CR	L	Cabécar
CJR	CR	E	Chorotega
CJS	RU	L	Shor
CJU	RU	L	Chuvash
CJV	PG	L	Chuave
CJY	CN	L	Chinese, Jinyu
CKA	MM	L	Chin, Khumi Awa
CKC	GT	L	Cakchiquel, Northern
CKD	GT	L	Cakchiquel, South Central
CKE	GT	L	Cakchiquel, Eastern
CKF	GT	L	Cakchiquel, Southern
CKG	TZ	L	Kwavi
CKH	MM	L	Chak
CKI	GT	L	Cakchiquel, Santa María De Jesús
CKJ	GT	L	Cakchiquel, Santo Domingo Xenacoj
CKK	GT	L	Cakchiquel, Southwestern, Acatenango
CKL	NG	L	Cibak
CKM	MM	L	Chin, Khumi
CKN	GM	L	Kalanke
CKO	GH	L	Anufo
CKQ	TD	L	Kajakse
CKR	PG	L	Kairak
CKS	NC	L	Tayo
CKT	RU	L	Chukot
CKU	US	L	Koasati
CKV	TW	N	Kavalan
CKW	GT	L	Cakchiquel, Western
CKX	CM	L	Caka
CKY	NG	L	Cakfem-mushere
CKZ	GT	L	Cakchiquel-quiche Mixed Language
CLA	NG	L	Ron
CLD	IQ	L	Chaldean Neo-aramaic
CLE	MX	L	Chinanteco, Lealao
CLH	PK	L	Chilisso
CLI	GH	L	Chakali
CLK	IN	L	Idu
CLM	US	N	Clallam
CLN	ES	L	Catalan-valencian-balear
CLO	MX	L	Chontal De Oaxaca, Costa
CLY	MX	L	Chatino, Sierra Oriental
CMA	VN	L	Maa
CMI	CO	L	Emberá-chamí
CML	ID	L	Campalagian
CMR	MM	L	Chin, Mro
CMT	ZA	L	Camtho
CNA	IN	L	Changthang
CNB	MM	L	Chin, Chinbon
CNG	CN	L	Qiang, Northern
CNH	MM	L	Chin, Haka
CNI	PE	L	Asháninca
CNL	MX	L	Chinanteco, Lalana
CNM	GT	L	Chuj, San Mateo Ixtatán
CNO	LA	L	Con
CNT	MX	L	Chinanteco, Tepetotutla
CNW	MM	L	Chin, Ngawn
COA	MY	L	Malay, Cocos Islands
COB	MX	E	Chicomuceltec
COC	MX	L	Cocopa
COD	PE	L	Cocama-cocamilla
COE	CO	L	Koreguaje
COF	EC	L	Colorado
COG	KH	L	Chong
COH	KE	L	Chonyi
COI	FR	L	Corsican
COJ	MX	E	Cochimí
COK	MX	L	Cora, Santa Teresa
COL	US	L	Columbia-wenatchi
COM	US	L	Comanche
CON	EC	L	Cofán
COO	CA	L	Comox
COP	EG	E	Coptic
COQ	US	E	Coquille
COR	MX	L	Cora
COS	US	N	Coos
COT	PE	L	Caquinte
COU	SN	L	Wamei
COV	CN	L	Cao Miao
COW	US	N	Cowlitz
COX	PE	L	Nanti
COY	CO	E	Coyaima
COZ	MX	L	Chochoteco
CPA	MX	L	Chinanteco, Palantla
CPB	PE	L	Ashéninca Ucayali-yurúa
CPC	PE	L	Ajyíninka Apurucayali
CPE	NR	L	Chinese Pidgin English
CPG	GR	E	Cappadocian Greek
CPN	GH	L	Cherepon
CPP	PE	L	Ashéninca Perené
CPS	PH	L	Capiznon
CPU	PE	L	Ashéninca Pichis
CPW	CA	L	Chipewyan
CPX	CN	L	Chinese, Pu-xian
CRA	ET	L	Chara
CRB	VE	L	Carib
CRC	VU	L	Lonwolwol
CRD	US	N	Coeur D'alene
CRE	CA	L	Cree, Southern East
CRG	US	L	Michif
CRH	UZ	L	Crimean Turkish
CRI	ST	L	Sãotomense
CRK	US	L	Muskogee
CRL	CA	L	Cree, Northern East
CRM	CA	L	Cree, Moose
CRN	GB	L	Cornish
CRO	US	L	Crow
CRP	CA	L	Cree, Plains
CRQ	AR	L	Chorote, Iyo'wujwa
CRS	SC	L	Seselwa Creole French
CRT	AR	L	Chorote, Iyojwa'ja
CRU	BR	L	Carútana
CRW	CA	N	Chinook Wawa
CRY	NG	L	Cori
CRZ	US	E	Cruzeño
CSA	MX	L	Chinanteco, Chiltepec
CSB	PL	L	Kashubian
CSC	ES	L	Catalonian Sign Language
CSD	TH	L	Chiangmai Sign Language
CSE	CZ	L	Czech Sign Language
CSG	CL	L	Chilean Sign Language
CSH	MM	L	Chin, Asho
CSI	US	N	Miwok, Coast
CSK	SN	L	Jola-kasa
CSL	CN	L	Chinese Sign Language
CSM	US	N	Miwok, Central Sierra
CSN	CO	L	Colombian Sign Language
CSO	MX	L	Chinanteco, Sochiapan
CSR	CR	L	Costa Rican Sign Language
CSS	US	E	Costanoan, Southern
CST	US	E	Costanoan, Northern
CSW	CA	L	Cree, Swampy
CSY	MM	L	Chin, Siyin
CTA	MX	L	Chatino, Tataltepec
CTD	MM	L	Chin, Tedim
CTE	MX	L	Chinanteco, Tepinapa
CTI	MX	L	Ch'ol, Tila
CTL	MX	L	Chinanteco, Tlacoatzintepec
CTN	NP	N	Chhintang
CTO	CO	L	Emberá-catío
CTP	MX	L	Chatino, Sierra Occidental
CTS	PH	L	Bicolano, Northern Catanduanes
CTU	MX	L	Ch'ol, Tumbalá
CTZ	MX	L	Chatino, Zacatepec
CUA	VN	L	Cua
CUB	CO	L	Cubeo
CUG	CM	L	Cung
CUH	KE	L	Chuka
CUI	CO	L	Cuiba
CUJ	PE	L	Mashco Piro
CUK	PA	L	Kuna, San Blas
CUL	BR	L	Culina
CUM	CO	E	Cumeral
CUN	GT	L	Quiché, Cunén
CUP	US	N	Cupeño
CUQ	CN	L	Cun
CUR	NP	L	Chhulung
CUS	MX	L	Chinanteco, Usila
CUT	MX	L	Cuicateco, Teutila
CUU	CN	L	Tai Ya
CUV	CM	L	Cuvok
CUW	NP	N	Chukwa
CUX	MX	L	Cuicateco, Tepeuxila
CWA	TZ	L	Kabwa
CWD	CA	L	Cree, Woods
CWE	TZ	L	Kwere
CWG	MY	L	Chewong
CWT	SN	L	Kuwaataay
CYA	MX	L	Chatino, Nopala
CYE	KY	L	Cayman Islands English
CYO	PH	L	Cuyonon
CZC	CZ	L	Czech
CZE	MX	L	Chatino, Zenzontepec
CZH	CN	L	Chinese, Huizhou
CZK	CZ	E	Knaanic
CZO	CN	L	Chinese, Min Zhong
CZT	MM	L	Chin, Zotung
DAA	TD	L	Dangaléat
DAB	CM	L	Daba
DAC	PG	L	Dambi
DAD	PG	L	Marik
DAE	CM	L	Duupa
DAF	CI	L	Dan
DAG	GH	L	Dagbani
DAH	PG	L	Gwahatike
DAI	TD	L	Day
DAJ	SD	L	Daju, Dar Fur
DAK	TD	L	Dazaga
DAL	KE	L	Dahalo
DAN	BR	L	Dení
DAO	MM	L	Chin, Daai
DAP	IN	L	Nisi
DAQ	IN	L	Maria, Dandami
DAR	RU	L	Dargwa
DAS	CI	L	Daho-doo
DAT	CN	L	Darang Deng
DAU	TD	L	Daju, Dar Sila
DAV	KE	L	Taita
DAW	PH	L	Davawenyo
DAX	AU	N	Dayi
DAY	MN	L	Darkhat
DAZ	ID	L	Dao
DBB	NG	L	Deno
DBD	NG	L	Dadiya
DBE	ID	L	Dabe
DBF	ID	L	Edopi
DBI	NG	L	Doka
DBJ	MY	L	Ida'an
DBL	AU	N	Dyirbal
DBM	NG	L	Duguri
DBN	ID	L	Duriankere
DBO	NG	L	Dulbu
DBP	NG	L	Duwai
DBR	SO	L	Dabarre
DBV	NG	L	Dungu
DCC	IN	L	Deccan
DCR	VI	E	Dutch Creole
DDD	SD	L	Dongotono
DDG	TP	L	Fataluku
DDI	PG	L	Diodio
DDJ	AU	L	Jaru
DDO	RU	L	Dido
DDW	ID	L	Dawera-daweloor
DEA	PG	L	Dengalu
DEC	SD	L	Dagik
DED	PG	L	Dedua
DEE	LR	L	Dewoin
DEG	NG	L	Degema
DEH	PK	L	Dehwari
DEI	ID	L	Demisa
DEK	CM	L	Dek
DEL	US	N	Unami
DEM	ID	L	Dem
DEN	BJ	L	Dendi
DEP	US	E	Delaware, Pidgin
DEQ	CF	L	Dendi
DER	IN	L	Deori
DES	BR	L	Desano
DET	BW	L	Deti
DEU	NC	L	Dehu
DEV	PG	L	Domung
DEZ	ZR	L	Dengese
DGA	GH	L	Dagaare, Southern
DGB	CA	L	Dogrib
DGC	PH	L	Agta, Casiguran Dumagat
DGD	BF	L	Dagaari Dioula
DGE	PG	L	Degenan
DGG	PG	L	Doga
DGH	NG	L	Dghwede
DGI	BF	L	Dagara, Northern
DGK	CF	L	Dagba
DGM	GH	L	Dangme
DGR	IN	L	Degaru
DGS	BF	L	Dogoso
DGZ	PG	L	Daga
DHA	IN	L	Dhanwar
DHG	US	L	Dakota
DHI	NP	L	Dhimal
DHL	AU	L	Dhalandji
DHM	AO	L	Zemba
DHN	IN	L	Dhanki
DHO	IN	L	Dhodia
DHR	AU	N	Dhargari
DHS	TZ	L	Dhaiso
DHU	AU	E	Dhurga
DHW	NP	L	Dhanwar
DIA	PG	L	Dia
DIB	SD	L	Dinka, South Central
DIC	CI	L	Dida, Lakota
DID	SD	L	Didinga
DIE	CI	L	Ega
DIF	AU	E	Dieri
DIG	KE	L	Digo
DIH	MX	L	Kumiái
DII	CM	L	Dimbong
DIJ	ID	L	Dai
DIK	SD	L	Dinka, Southwestern
DIL	SD	L	Dilling
DIM	ET	L	Dime
DIN	SD	L	Dinka, Southeastern
DIO	NG	L	Dibo
DIP	SD	L	Dinka, Northeastern
DIR	NG	L	Dirim
DIS	IN	L	Dimasa
DIT	AU	N	Dirari
DIU	NA	L	Diriku
DIV	TD	L	Disa
DIW	SD	L	Dinka, Northwestern
DIX	VU	L	Dixon Reef
DIY	ID	L	Diuwe
DIZ	ZR	L	Ding
DJB	AU	L	Djinba
DJC	TD	L	Daju, Dar Daju
DJD	AU	L	Djamindjung
DJE	NE	L	Zarma
DJF	AU	N	Djangun
DJI	AU	L	Djinang
DJJ	AU	L	Djeebbana
DJK	SR	L	Aukan
DJL	AU	N	Djiwarli
DJN	AU	L	Djauan
DJO	ID	L	Djongkang
DJR	AU	L	Djambarrpuyngu
DJU	PG	L	Kapriman
DJW	AU	N	Djawi
DKA	BT	L	Dakpakha
DKK	ID	L	Dakka
DKR	MY	L	Kuijau
DLC	SE	L	Dalecarlian
DLG	RU	L	Dolgan
DLM	HR	E	Dalmatian
DLN	BD	L	Darlong
DMA	GA	L	Duma
DMC	PG	L	Dimir
DME	CM	L	Dugwor
DMG	MY	L	Kinabatangan, Upper
DMK	PK	L	Domaaki
DML	PK	L	Dameli
DMM	CM	L	Dama
DMO	CM	L	Kemezung
DMP	ID	N	Dampal
DMR	ID	L	Damar, East
DMS	ID	L	Dampelasa
DMU	ID	L	Dubu
DMV	MY	L	Dumpas
DMY	ID	L	Demta
DNA	ID	L	Dani, Upper Grand Valley
DND	PG	L	Daonda
DNE	TZ	L	Ndendeule
DNG	KG	L	Dungan
DNI	ID	L	Dani, Lower Grand Valley
DNN	BF	L	Dzùùngoo
DNR	PG	L	Danaru
DNS	DK	L	Danish
DNT	ID	L	Dani, Mid Grand Valley
DNU	MM	L	Danau
DNW	ID	L	Dani, Western
DOA	PG	L	Dom
DOB	PG	L	Dobu
DOC	CN	L	Dong, Northern
DOD	CG	L	Doondo
DOE	TZ	L	Doe
DOF	PG	L	Domu
DOG	ML	L	Dogon
DOH	NG	L	Dong
DOI	PG	L	Moikodi
DOJ	IN	L	Dogri-kangri
DOK	ID	L	Dondo
DOL	PG	L	Doso
DOM	LC	L	Lesser Antillean Creole French
DON	PG	L	Doura
DOO	ZR	L	Dongo
DOP	BJ	L	Lukpa
DOQ	DO	L	Dominican Sign Language
DOR	SB	L	Dori'o
DOS	BF	L	Dogosé
DOT	NG	L	Dass
DOU	CM	L	Duala
DOV	ZW	L	Dombe
DOW	CM	L	Doyayo
DOX	ET	L	Bussa
DOY	GH	L	Dompo
DOZ	ET	L	Dorze
DPP	MY	L	Papar
DRA	AF	L	Pashayi, Southeast
DRB	SD	L	Dair
DRD	IN	L	Darmiya
DRE	NP	L	Dolpo
DRG	MY	L	Rungus
DRI	NG	L	C'lela
DRL	AU	N	Darling
DRN	ID	L	Damar, West
DRO	MY	L	Daro-matu
DRR	SB	E	Dororo
DRS	ET	L	Gedeo
DRT	NL	L	Drents
DRU	TW	L	Rukai
DRW	AF	L	Darwazi
DRY	NP	L	Darai
DSE	NL	L	Dutch Sign Language
DSH	ET	L	Daasanach
DSL	DK	L	Danish Sign Language
DSN	ID	N	Dusner
DSQ	ML	L	Tadaksahak
DTA	CN	L	Daur
DTB	MY	L	Kadazan, Labuk-kinabatangan
DTP	MY	L	Dusun, Central
DTR	MY	L	Lotud
DUA	PG	L	Duau
DUB	IN	L	Dubli
DUC	PG	L	Duna
DUD	NG	L	Hun-saare
DUE	PH	L	Agta, Umiray Dumaget
DUF	NC	L	Dumbea
DUG	KE	L	Duruma
DUH	IN	L	Dungra Bhil
DUI	PG	L	Dumun
DUJ	AU	L	Dhuwal
DUK	PG	L	Duduela
DUL	PH	L	Agta, Alabat Island
DUM	GH	L	Gonja
DUN	ID	L	Dusun Deyah
DUO	PH	L	Agta, Dupaninan
DUP	MY	L	Duano'
DUQ	ID	L	Dusun Malang
DUR	CM	L	Dii
DUS	NP	L	Dumi
DUT	NL	L	Dutch
DUU	CN	L	Drung
DUV	ID	L	Duvle
DUW	ID	L	Dusun Witu
DUX	ML	L	Duungoma
DUY	PH	E	Agta, Dicamay
DUZ	CM	E	Duli
DWA	NG	L	Diri
DWW	PG	L	Dawawa
DYA	BF	L	Dyan
DYB	AU	N	Dyaberdyaber
DYD	AU	N	Dyugun
DYG	PH	L	Agta, Villa Viciosa
DYI	CI	L	Senoufo, Djimini
DYK	ID	L	Dayak, Land
DYN	AU	N	Dyangadi
DYO	SN	L	Jola-fogny
DYU	BF	L	Jula
DYY	AU	N	Dyaabugay
DZA	NG	L	Duguza
DZD	NG	L	Daza
DZH	IL	L	Dzhidi
DZL	BT	L	Dzalakha
DZN	ZR	L	Dzando
DZO	BT	L	Dzongkha
EBG	NG	L	Ebughu
EBR	CI	L	Ebrié
EBU	KE	L	Embu
ECS	EC	L	Ecuadorian Sign Language
EDO	NG	L	Edo
EEE	CN	L	E
EFA	NG	L	Efai
EFE	ZR	L	Efe
EFK	NG	L	Efik
EGO	NG	L	Eggon
EHU	NG	L	Ehueun
EIP	ID	L	Eipomek
EIT	PG	L	Eitiep
EIV	PG	L	Eivo
EJA	GW	L	Ejamat
EKA	NG	L	Ekajuk
EKE	NG	L	Ekit
EKG	ID	L	Ekari
EKI	NG	L	Eki
EKM	CM	L	Elip
EKO	MZ	L	Koti
EKP	NG	L	Ekpeye
EKR	NG	L	Yace
EKY	MM	L	Kayah, Eastern
ELE	PG	L	Elepi
ELH	SD	L	El Hugeirat
ELI	SD	L	Nding
ELK	PG	L	Elkei
ELL	TV	L	Tuvaluan
ELM	NG	L	Eleme
ELO	KE	N	El Molo
ELP	ID	L	Elpaputih
ELU	PG	L	Elu
EMA	NG	L	Emai-iuleha-ora
EMB	ID	L	Embaloh
EME	GF	L	Emerillon
EMG	NP	L	Meohang, Eastern
EMI	PG	L	Mussau-emira
EML	IT	L	Emiliano-romagnolo
EMN	CM	L	Eman
EMO	PY	E	Emok
EMP	PA	L	Emberá, Northern
EMS	US	L	Yupik, Pacific Gulf
EMU	IN	L	Muria, Eastern
EMW	ID	L	Emplawas
ENA	PG	L	Apali
ENB	KE	L	Endo
ENC	VN	L	En
END	ID	L	Ende
ENE	RU	L	Enets
ENG	GB	L	English
ENI	ID	L	Enim
ENN	NG	L	Engenni
ENO	ID	L	Enggano
ENQ	PG	L	Enga
ENR	ID	L	Emumu
ENW	NG	L	Enwan
EOT	CI	L	Beti
EPI	NG	L	Epie
ERG	VU	L	Sie
ERH	NG	L	Eruwa
ERI	PG	L	Ogea
ERK	VU	L	Efate, South
ERO	CN	L	Horpa
ERR	AU	N	Erre
ERS	CN	L	Ersu
ERW	ID	L	Erokwanas
ESB	CA	L	Inuktitut, Eastern Canadian
ESC	CA	L	Inuktitut, Western Canadian
ESE	BO	L	Ese Ejja
ESG	GL	L	Inuktitut, Greenlandic
ESH	IR	L	Eshtehardi
ESI	US	L	Inupiatun, North Alaskan
ESK	US	L	Inupiatun, Northwest Alaska
ESM	CI	E	Esuma
ESN	SV	L	Salvadoran Sign Language
ESO	EE	L	Estonian Sign Language
ESP	FR	L	Esperanto
ESQ	US	E	Esselen
ESS	US	L	Yupik, Central Siberian
EST	EE	L	Estonian
ESU	US	L	Yupik, Central
ETB	NG	L	Etebi
ETH	ET	L	Ethiopian Sign Language
ETN	VU	L	Eton
ETO	CM	L	Eton
ETR	PG	L	Edolo
ETS	NG	L	Yekhee
ETU	NG	L	Ejagham
ETZ	ID	L	Semimi
EUR	BE	L	Europanto
EVE	RU	L	Even
EVH	NG	L	Uvbie
EVN	CN	L	Evenki
EWE	GH	L	éwé
EWO	CM	L	Ewondo
EXT	ES	L	Extremaduran
EYA	US	N	Eyak
EZE	NG	L	Uzekwe
FAA	PG	L	Fasu
FAB	GQ	L	Fa D'ambu
FAC	IR	L	Fars
FAD	PG	L	Wagi
FAE	DK	L	Faroese
FAF	SB	L	Fagani
FAG	PG	L	Finungwa
FAH	NG	N	Fali Of Baissa
FAI	PG	L	Faiwol
FAL	CM	L	Fali, South
FAM	NG	L	Fam
FAN	TD	L	Fania
FAO	ZA	L	Fanagolo
FAP	SN	L	Palor
FAR	SB	L	Fataleka
FAS	PG	L	Fas
FAT	PG	L	Faita
FAU	ID	L	Fayu
FAX	ES	L	Fala
FCS	CA	L	Quebec Sign Language
FER	SD	L	Feroge
FGR	TD	L	Fongoro
FIA	SD	L	Nobiin
FIE	NG	L	Fyer
FIN	FI	L	Finnish
FIP	TZ	L	Fipa
FIR	NG	L	Firan
FIT	SE	L	Finnish, Tornedalen
FIW	PG	L	Fiwaga
FIZ	NG	L	Izere
FJI	FJ	L	Fijian
FKV	NO	L	Finnish, Kven
FLA	US	N	Kalispel-pend D'oreille
FLH	ID	L	Foau
FLI	NG	L	Fali
FLL	CM	L	Fali, North
FLN	AU	N	Flinders Island
FLR	ZR	L	Fuliiru
FLY	ZA	L	Tsotsitaal
FMP	CM	L	Fe'fe'
FMU	IN	L	Muria, Far Western
FNG	GA	L	Fang
FOA	BJ	L	Fon-gbe
FOD	BJ	L	Foodo
FOI	PG	L	Foi
FOM	ZR	L	Foma
FOR	PG	L	Fore
FOS	TW	E	Siraiya
FPE	GQ	L	Fernando Po Creole English
FRA	FR	L	Franco-provençal
FRC	US	L	French, Cajun
FRD	ID	L	Fordata
FRE	GF	L	French Guianese Creole French
FRI	NL	L	Frisian, Western
FRK	DE	E	Frankish
FRL	IT	L	Friulian
FRN	FR	L	French
FRO	PG	L	Forak
FRR	DE	L	Frisian, Northern
FRS	DE	L	Frisian, Eastern
FRT	VU	L	Fortsenal
FRY	ID	L	Mairasi
FSE	FI	L	Finnish Sign Language
FSL	FR	L	French Sign Language
FUB	CM	L	Fulfulde, Adamawa
FUC	SN	L	Pulaar
FUD	WF	L	Futuna, East
FUE	BJ	L	Fulfulde, Benin-togo
FUF	GN	L	Fuuta Jalon
FUG	CM	L	Fungom
FUH	NE	L	Fulfulde, Western Niger
FUI	TD	L	Fulfulde, Bagirmi
FUJ	SD	L	Ko
FUL	ML	L	Fulfulde, Maasina
FUM	NG	L	Fum
FUN	BR	L	Fulniô
FUQ	NE	L	Fulfulde, Central-eastern Niger
FUR	SD	L	Fur
FUT	VU	L	Futuna-aniwa
FUU	ZR	L	Furu
FUV	NG	L	Fulfulde, Nigerian
FUY	PG	L	Fuyug
FWA	NC	L	Fwâi
FWE	NA	L	Fwe
GAA	NG	L	Ga'anda
GAB	TD	L	Gabri
GAC	GH	L	Ga
GAD	PH	L	Gaddang
GAE	VE	L	Guarequena
GAF	PG	L	Gende
GAG	MD	L	Gagauz
GAH	PG	L	Alekano
GAI	PG	L	Borei
GAJ	PG	L	Gadsup
GAK	ID	L	Gamkonora
GAL	TP	L	Galoli
GAM	PG	L	Kandawo
GAN	NG	L	Aten
GAO	PG	L	Gants
GAP	PG	L	Gal
GAQ	IN	L	Gata'
GAR	PG	L	Galeya
GAS	IN	L	Garasia, Adiwasi
GAT	PG	L	Kenati
GAU	IN	L	Gadaba, Ollar, Salur
GAV	PG	L	Gabutamon
GAW	PG	L	Nobanob
GAX	ET	L	Oromo, Borana-arsi-guji
GAY	BR	L	Gavião, Pará
GAZ	ET	L	Oromo, West-central
GBA	LR	L	Bandi
GBB	AU	L	Kaytetye
GBC	AU	L	Garawa
GBD	AU	N	Karadjeri
GBE	PG	L	Niksek
GBF	PG	L	Gaikundi
GBG	CF	L	Gbanziri
GBI	ID	L	Galela
GBJ	IN	L	Gadaba, Bodo
GBK	IN	L	Gaddi
GBL	IN	L	Gamit
GBM	IN	L	Garhwali
GBN	SD	L	Mo'da
GBP	CF	L	Gbaya-bossangoa
GBQ	CF	L	Gbaya-bozoum
GBR	NG	L	Gbagyi
GBU	AU	N	Gagadu
GBV	CF	L	Gbanu
GBW	NG	L	Gbagyi Nkwa
GBY	NG	L	Gbari
GBZ	IR	L	Dari
GCC	PG	L	Mali
GCD	AU	N	Ganggalida
GCE	US	E	Galice
GCN	PG	L	Gaina
GCT	VE	L	German, Colonia Tovar
GDA	IN	L	Lohar, Gade
GDB	IN	L	Gadaba, Ollar, Pottangi
GDC	AU	N	Gugu Badhun
GDD	PG	L	Gedaged
GDE	NG	L	Gude
GDF	NG	L	Guduf-gava
GDG	PH	L	Ga'dang
GDH	AU	N	Gadjerawang
GDI	CF	L	Gundi
GDJ	AU	N	Gurdjar
GDK	TD	L	Gadang
GDL	ET	L	Dirasha
GDM	TD	L	Laal
GDN	PG	L	Umanakaina
GDO	RU	L	Ghodoberi
GDR	PG	L	Gidra
GDU	NG	L	Gudu
GDW	CM	L	Gaduwa
GEA	NG	L	Geruma
GEB	PG	L	Kire
GEC	LR	L	Grebo, Gboloo
GED	NG	L	Gade
GEE	ET	E	Geez
GEG	NG	L	Gengle
GEH	CA	L	German, Hutterite
GEI	ID	L	Gebe
GEJ	TG	L	Gen-gbe
GEK	NG	L	Yiwom
GEL	NG	L	Kag-fer-jiir-koor-ror-us-zuksun
GEN	CN	L	Geman Deng
GEO	GE	L	Georgian
GEQ	CF	L	Geme
GER	DE	L	German, Standard
GES	ID	L	Geser-gorom
GET	PG	L	Getmata
GEW	NG	L	Gera
GEX	SO	L	Garre
GEY	ZR	L	Enya
GEZ	NG	L	Geji
GFK	PG	L	Patpatar
GFT	ET	E	Gafat
GGA	SB	L	Gao
GGB	LR	L	Gbii
GGD	AU	N	Gugadj
GGE	AU	L	Guragone
GGG	PK	L	Gurgula
GGH	KE	L	Garreh-ajuran
GGK	AU	E	Kungarakany
GGL	PG	L	Ganglau
GGN	NP	L	Gurung, Eastern
GGO	IN	L	Gondi, Southern
GGR	AU	E	Aghu Tharnggalu
GGU	CI	L	Gagu
GHA	LY	L	Ghadamès
GHE	NP	L	Ghale, Southern
GHH	NP	L	Ghale, Northern
GHK	MM	L	Karen, Geko
GHL	SD	L	Ghulfan
GHN	SB	L	Ghanongga
GHO	MA	E	Ghomara
GHR	PK	L	Ghera
GHS	PG	L	Guhu-samane
GHT	NP	L	Ghale, Kutang
GIA	AU	L	Kitja
GIB	NG	L	Gibanawa
GIC	ZA	L	Gail
GID	CM	L	Gidar
GIG	PK	L	Goaria
GIL	PG	L	Gitua
GIM	PG	L	Gimi
GIN	RU	L	Hinukh
GIP	PG	L	Gimi
GIS	CM	L	Giziga, North
GIT	CA	L	Gitxsan
GIX	ZR	L	Gilima
GIY	AU	N	Giyug
GIZ	CM	L	Giziga, South
GJK	PK	L	Koli, Kachi
GJR	IN	L	Gujarati
GJU	IN	L	Gujari
GKA	PG	L	Guiarak
GKE	CM	N	Ndai
GKN	NG	L	Gokana
GKO	GR	E	Greek, Ancient
GKP	GN	L	Kpelle, Guinea
GLA	AU	L	Dhangu
GLB	KI	L	Kiribati
GLC	TD	L	Bon Gula
GLD	RU	L	Nanai
GLE	SD	E	Gule
GLG	SB	E	Guliguli
GLH	AF	L	Pashayi, Northwest
GLI	IE	L	Gaelic, Irish
GLJ	TD	L	Gula Iro
GLK	IR	L	Gilaki
GLN	ES	L	Galician
GLO	NG	L	Galambu
GLR	LR	L	Glaro-twabo
GLS	GB	L	Gaelic, Scots
GLU	TD	L	Gula
GLV	NG	L	Glavda
GMA	AU	N	Gambera
GMB	SB	L	Gula'alaa
GMD	NG	L	Mághdì
GMO	ET	L	Gamo-gofa-dawro
GMU	PG	L	Gumalu
GNA	BF	L	Kaansa
GNB	IN	L	Gangte
GNC	ES	E	Guanche
GND	CM	L	Gemzek
GNE	BW	L	Ganádi
GNG	TG	L	Ngangam
GNH	NG	N	Lere
GNI	AU	L	Gooniyandi
GNK	BW	L	//Gana
GNL	AU	E	Gangulu
GNM	PG	L	Ginuman
GNN	AU	L	Gumatj
GNQ	MY	L	Gana
GNR	AU	E	Gureng Gureng
GNT	PG	L	Guntai
GNU	PG	L	Gnau
GNW	BO	L	Guaraní, Bolivian, Western
GNZ	CF	L	Ganzi
GOA	CI	L	Guro
GOB	CO	L	Playero
GOC	PG	L	Gorakor
GOD	CI	L	Godié
GOE	BT	L	Gongduk
GOF	UA	E	Gothic
GOG	TZ	L	Gogo
GOH	PG	L	Gogodala
GOI	PG	L	Gobasi
GOJ	IN	L	Gowlan
GOK	IN	L	Gowli
GOL	LR	L	Gola
GOM	IN	L	Konkani, Goanese
GON	IN	L	Gondi, Northern
GOO	FJ	L	Gone Dau
GOP	ID	L	Yeretuar
GOQ	ID	L	Gorap
GOR	NP	L	Bujhyal
GOS	NL	L	Gronings
GOT	BF	L	Cerma
GOU	CM	L	Gavar
GOW	TZ	L	Gorowa
GOX	ZR	L	Gobu
GOY	TD	N	Goundo
GOZ	IR	L	Gozarkhani
GPA	NG	L	Gupa-abawa
GPN	PG	L	Taiap
GQI	CN	L	Guiqiong
GQR	TD	L	Gor
GRA	IN	L	Garasia, Rajput
GRB	LR	L	Grebo, Northern
GRC	NG	L	Gurmana
GRD	NG	L	Guruntum-mbaaru
GRE	ET	L	Gurage, East
GRG	PG	L	Gira
GRH	NG	L	Gbiri-niragu
GRI	SB	L	Ghari
GRJ	LR	L	Grebo, Southern
GRK	GR	L	Greek
GRL	ID	L	Gorontalo
GRM	MY	L	Kota Marudu Talantang
GRN	CA	L	Plautdietsch
GRO	CN	L	Groma
GRQ	PG	N	Gorovu
GRR	DZ	L	Taznatit
GRS	ID	L	Gresi
GRT	IN	L	Garo
GRU	ET	L	Gurage, Soddo
GRV	LR	L	Grebo, Central
GRW	PG	N	Gweda
GRX	PG	L	Guriaso
GRY	LR	L	Grebo, Barclayville
GRZ	PG	N	Guramalum
GSA	PG	L	Gasmata
GSC	FR	L	Gascon
GSE	GH	L	Ghanaian Sign Language
GSG	DE	L	German Sign Language
GSL	SN	L	Gusilay
GSM	GT	L	Guatemalan Sign Language
GSN	PG	L	Gusan
GSP	PG	L	Wasembo
GSS	GR	L	Greek Sign Language
GSW	CH	L	Alemannisch
GTA	BR	L	Guató
GTI	ZR	L	Gbati-ri
GUA	NG	L	Shiki
GUB	BR	L	Guajajára
GUC	CO	L	Wayuu
GUD	CI	L	Dida, Yocoboué
GUE	AU	L	Gurinji
GUF	AU	L	Gupapuyngu
GUG	PY	L	Guaraní, Paraguayan
GUH	CO	L	Guahibo
GUI	BO	L	Guaraní, Bolivian, Eastern
GUJ	BR	L	Guajá
GUK	ET	L	Gumuz
GUL	US	L	Sea Island Creole English
GUM	CO	L	Guambiano
GUN	PY	L	Guaraní, Mbyá
GUO	CO	L	Guayabero
GUP	AU	L	Gunwinggu
GUQ	PY	L	Aché
GUR	GH	L	Frafra
GUS	GN	L	Guinean Sign Language
GUT	CR	L	Maléku Jaíka
GUU	VE	L	Yanomamö
GUV	CM	E	Gey
GUW	BJ	L	Gun-gbe
GUX	BF	L	Gourmancéma
GUY	ET	L	Gurage, West
GUZ	KE	L	Gusii
GVA	PY	L	Guana
GVC	BR	L	Guanano
GVE	PG	L	Duwet
GVF	PG	L	Golin
GVL	TD	L	Gulay
GVN	AU	L	Kuku-yalanji
GVO	BR	L	Gavião Do Jiparaná
GVR	NP	L	Gurung, Western
GVS	PG	L	Gumawana
GWA	CI	L	Mbato
GWB	NG	L	Gwa
GWC	PK	L	Kalami
GWD	ET	L	Gawwada
GWE	TZ	L	Gweno
GWF	PK	L	Gowro
GWG	NG	L	Moo
GWJ	BW	L	/Gwi
GWN	NG	L	Gwandara
GWR	UG	L	Gwere
GWT	AF	L	Gawar-bati
GWU	AU	N	Guwamu
GWW	AU	L	Kwini
GWX	GH	L	Gua
GXX	CI	L	Wè Southern
GYA	CF	L	Gbaya, Northwest
GYB	PG	L	Garus
GYD	AU	L	Gayardilt
GYE	NG	L	Gyem
GYF	AU	N	Gungabula
GYG	CF	L	Gbayi
GYI	CM	L	Gyele
GYM	PA	L	Ngäbere
GYN	GY	L	Guyanese Creole English
GYO	ID	L	Gayo
GYR	BO	L	Guarayu
GYY	AU	N	Gunya
GZA	ET	N	Ganza
GZI	IR	L	Gazi
GZN	ID	L	Gane
HAA	US	N	Han
HAB	VN	L	Hanoi Sign Language
HAC	IQ	L	Hawrami
HAD	ID	L	Hatam
HAE	ET	L	Oromo, Eastern
HAF	VN	L	Haiphong Sign Language
HAG	GH	L	Hanga
HAH	PG	L	Hahon
HAI	CA	N	Haida, Northern
HAJ	IN	L	Hajong
HAK	CN	L	Chinese, Hakka
HAL	VN	L	Halang
HAM	PG	L	Hewa
HAN	TZ	L	Hangaza
HAO	PG	L	Hakö
HAP	ID	L	Hupla
HAQ	TZ	L	Ha
HAR	ET	L	Harari
HAS	CA	L	Haisla
HAT	HT	L	Haitian Creole French
HAU	MX	L	Huasteco, San Francisco Chontla
HAV	ZR	L	Havu
HAW	US	L	Hawai'i Creole English
HAX	CA	N	Haida, Southern
HAY	TZ	L	Haya
HAZ	AF	L	Hazaragi
HBA	ZR	L	Hamba
HBH	MM	L	Chin, Falam
HBO	IL	E	Hebrew, Ancient
HBR	IL	L	Hebrew
HBU	TP	L	Habu
HCH	MX	L	Huichol
HDY	ET	L	Hadiyya
HEA	CN	L	Hmong, Northern Qiandong
HEB	SD	L	Heiban
HED	TD	L	Herdé
HEG	ID	L	Helong
HEH	TZ	L	Hehe
HEI	CA	L	Heiltsuk
HEK	IQ	L	Herki
HEM	ZR	L	Hemba
HER	NA	L	Herero
HGM	NA	L	Hai//om
HGW	PG	L	Haigwai
HHR	SN	L	Kerak
HIA	NG	L	Lamang
HIB	PE	E	Hibito
HID	US	L	Hidatsa
HIE	BW	L	Hietshware
HIF	FJ	L	Hindustani, Fijian
HIG	NG	L	Kamwe
HIH	PG	L	Hinihon
HII	IN	L	Hinduri
HIJ	CM	L	Hijuk
HIK	ID	L	Seit-kaitetu
HIL	PH	L	Hiligaynon
HIN	PK	L	Hindko, Southern
HIR	BR	L	Himarimã
HIT	ID	L	Hitu
HIW	VU	L	Hiw
HIX	BR	L	Hixkaryána
HKA	TZ	L	Kahe
HKE	ZR	L	Hunde
HLA	PG	L	Halia
HLB	IN	L	Halbi
HLD	VN	L	Halang Doan
HLO	BR	L	Haló Té Sú
HMA	CN	L	Hmong, Southern Mashan
HMB	ML	L	Songhay, Humburi Senni
HMC	CN	L	Hmong, Central Huishui
HMD	CN	L	Hmong, Northeastern Dian
HME	CN	L	Hmong, Eastern Huishui
HMG	CN	L	Hmong, Southwestern Guiyang
HMH	CN	L	Hmong, Southwestern Huishui
HMJ	CN	L	Hmong, Chonganjiang
HML	CN	L	Hmong, Luopohe
HMM	CN	L	Hmong, Central Mashan
HMN	CN	L	Hmong, Northern Huishui
HMO	CN	L	Hmong, Northern Mashan
HMQ	CN	L	Hmong, Eastern Qiandong
HMR	IN	L	Hmar
HMS	CN	L	Hmong, Southern Qiandong
HMT	PG	L	Hamtai
HMU	ID	L	Hamap
HMW	CN	L	Hmong, Western Mashan
HMY	CN	L	Hmong, Southern Guiyang
HNA	CM	L	Mina
HND	IN	L	Hindi
HNE	IN	L	Chhattisgarhi
HNG	HU	L	Hungarian
HNH	BW	L	/Anda
HNI	CN	L	Hani
HNN	PH	L	Hanunoo
HNO	PK	L	Hindko, Northern
HNS	SR	L	Hindustani, Caribbean
HNU	LA	L	Hung
HOA	SB	L	Hoava
HOB	PG	L	Mari
HOC	IN	L	Ho
HOD	NG	N	Holma
HOE	NG	L	Horom
HOH	OM	L	Hobyót
HOI	US	N	Holikachuk
HOJ	IN	L	Harauti
HOL	AO	L	Holu
HOM	SD	E	Homa
HON	TW	E	Hoanya
HOO	TZ	L	Holoholo
HOP	US	L	Hopi
HOR	TD	E	Horo
HOS	VN	L	Ho Chi Minh City Sign Language
HOT	PG	L	Hote
HOV	ID	L	Hovongan
HOW	CN	L	Honi
HOY	IN	L	Holiya
HOZ	ET	L	Hozo
HPO	MM	L	Hpon
HPS	US	L	Hawai'i Pidgin Sign Language
HRA	MM	L	Hrangkhol
HRE	VN	L	Hre
HRK	ID	L	Haruku
HRO	VN	L	Haroi
HRR	ID	L	Horuru
HRT	TR	L	Hértevin
HRU	IN	L	Hruso
HRZ	IR	L	Harzani
HSH	HU	L	Hungarian Sign Language
HSL	NG	L	Hausa Sign Language
HSN	CN	L	Chinese, Xiang
HSS	OM	L	Harsusi
HTI	ID	L	Hoti
HTO	CO	L	Huitoto, Mi+ni+ca
HTS	TZ	L	Hadza
HUA	NG	L	Hausa
HUB	PE	L	Huambisa
HUC	BW	L	=/Hua
HUD	ID	L	Huaulu
HUE	MX	L	Huave, San Francisco Del Mar
HUF	PG	L	Humene
HUG	PE	L	Huachipaeri
HUH	CL	L	Huilliche
HUI	PG	L	Huli
HUJ	CN	L	Hmong, Northern Guiyang
HUK	ID	N	Hulung
HUL	PG	L	Hula
HUM	ZR	L	Hungana
HUO	CN	L	Hu
HUP	US	N	Hupa
HUQ	CN	L	Tsat
HUR	CA	L	Halkomelem
HUS	MX	L	Huasteco, Tantoyuca
HUT	NP	L	Humla Bhotia
HUU	PE	L	Huitoto, Murui
HUV	MX	L	Huave, San Mateo Del Mar
HUW	ID	L	Hukumina
HUX	PE	L	Huitoto, Ni+pode
HUY	IL	L	Hulaulá
HUZ	RU	L	Hunzib
HVA	MX	L	Huasteco, San Luís Potosí
HVC	HT	L	Haitian Vodoun Culture Language
HVE	MX	L	Huave, San Dionisio Del Mar
HVN	ID	L	Sabu
HVV	MX	L	Huave, Santa María Del Mar
HWA	CI	L	Wané
HWI	US	L	Hawaiian
HWL	TG	L	Hwla
HWO	NG	L	Hwana
HYA	CM	L	Hya
IAI	NC	L	Iaai
IAN	PG	L	Iatmul
IAP	BR	L	Iapama
IAR	PG	L	Purari
IBA	MY	L	Iban
IBB	NG	L	Ibibio
IBD	AU	L	Iwaidja
IBE	NG	L	Akpes
IBG	PH	L	Ibanag
IBL	PH	L	Ibaloi
IBM	NG	L	Agoi
IBN	NG	L	Ibino
IBO	NG	L	Ibilo
IBR	NG	L	Ibuoro
IBU	ID	N	Ibu
IBY	NG	L	Ibani
ICA	BJ	L	Ica
ICE	IS	L	Icelandic
ICH	NG	L	Etkywan
ICL	IS	L	Icelandic Sign Language
IDA	KE	L	Idakho-isukha-tiriki
IDB	LK	L	Indo-portuguese
IDC	NG	L	Idon
IDD	BJ	L	Idaca
IDE	NG	L	Idere
IDI	PG	L	Idi
IDO	NG	L	Idoma
IDR	SD	L	Indri
IDT	TP	L	Idaté
IFA	PH	L	Ifugao, Amganad
IFB	PH	L	Ifugao, Batad
IFE	BJ	L	Ifè
IFF	VU	E	Ifo
IFK	PH	L	Ifugao, Tuwali
IFM	CG	L	Teke, South Central
IFU	PH	L	Ifugao, Mayoyao
IFY	PH	L	Kalanguya, Keley-i
IGB	NG	L	Ebira
IGE	NG	L	Igede
IGG	PG	L	Igana
IGL	NG	L	Igala
IGM	PG	L	Igom
IGN	BO	L	Ignaciano
IGO	PG	L	Isebe
IGR	NG	L	Igbo
IHB	ID	L	Iha Based Pidgin
IHP	ID	L	Iha
III	CN	L	Yi, Sichuan
IJC	NG	L	Izon
IJE	NG	L	Biseni
IJJ	BJ	L	Ije
IJN	NG	L	Kalabari
IJO	NG	L	Ijo, Southeast
IKI	NG	L	Iko
IKK	NG	L	Ika
IKO	NG	L	Olulumo-ikom
IKP	NG	L	Ikpeshi
IKU	NG	L	Ikulu
IKV	NG	L	Iku-gora-ankwa
IKW	NG	L	Ikwere
IKX	UG	L	Ik
IKZ	TZ	L	Ikizu
ILA	ID	L	Ile Ape
ILB	ZM	L	Ila
ILE	NG	L	Ilue
ILI	CN	L	Ili Turki
ILK	PH	L	Ilongot
ILL	MY	L	Ilanun
ILO	PH	L	Ilocano
ILU	ID	L	Iliun
ILW	ID	L	Talur
IME	MR	L	Imeraguen
IMI	PG	L	Anamgura
IMN	PG	L	Imonda
IMO	PG	L	Imbongu
IMR	ID	L	Imroing
INA	PE	N	Iñapari
INB	CO	L	Inga
IND	PG	L	Blafe
INE	US	E	Ineseño
ING	US	L	Degexit'an
INH	RU	L	Ingush
INJ	CO	L	Inga, Jungle
INL	ID	L	Indonesian Sign Language
INN	PH	L	Isinai
INO	PG	L	Inoke-yate
INR	FR	L	Interlingua
INS	IN	L	Indian Sign Language
INT	MM	L	Intha
INZ	ID	L	Indonesian
IOU	PG	L	Tuma-irumu
IOW	US	E	Iowa-oto
IPI	PG	L	Ipili
IPK	PG	L	Ipiko
IQU	PE	L	Iquito
IRA	BR	L	Irántxe
IRE	ID	L	Iresim
IRH	ID	L	Irarutu
IRI	NG	L	Irigwe
IRK	TZ	L	Iraqw
IRR	LA	L	Ir
IRU	IN	L	Irula
IRX	ID	L	Kamberau
IRY	PH	L	Iraya
ISA	PG	L	Isabi
ISC	PE	N	Isconahua
ISD	PH	L	Isnag
ISE	IT	L	Italian Sign Language
ISG	IE	L	Irish Sign Language
ISH	NG	L	Esan
ISI	NG	L	Nkem-nkum
ISL	IL	L	Israeli Sign Language
ISM	ID	L	Masimasi
ISN	TZ	L	Isanzu
ISO	NG	L	Isoko
IST	HR	L	Istriot
ISU	CM	L	Isu
ITB	PH	L	Itneg, Binongan
ITE	BO	E	Itene
ITG	BR	L	Itogapúk
ITI	PH	L	Itneg, Inlaod
ITK	IT	N	Judeo-italian
ITL	RU	L	Itelmen
ITM	NG	L	Itu Mbon Uzo
ITN	IT	L	Italian
ITO	BO	N	Itonama
ITR	PG	L	Iteri
ITS	NG	L	Isekiri
ITT	PH	L	Itneg, Southern
ITU	PG	L	Itutang
ITV	PH	L	Itawit
ITW	NG	L	Ito
ITX	ID	L	Itik
ITZ	GT	N	Itzá
IUM	CN	L	Iu Mien
IVB	PH	L	Ibatan
IVV	PH	L	Ivatan
IWK	PH	L	I-wak
IWM	PG	L	Iwam
IWO	ID	L	Iwur
IWS	PG	L	Iwam, Sepik
IXC	MX	L	Ixcateco
IXI	GT	L	Ixil, Nebaj
IXJ	GT	L	Ixil, Chajul
IXL	GT	L	Ixil, San Juan Cotzal
IYA	NG	L	Iyayu
IYO	CM	L	Mesaka
IZH	RU	L	Ingrian
IZI	NG	L	Izi-ezaa-ikwo-mgbo
JAA	BR	L	Jamamadí
JAB	NG	L	Ham
JAC	GT	L	Jacalteco, Eastern
JAD	GN	L	Jahanka
JAE	PG	L	Yabem
JAF	NG	L	Jara
JAH	MY	L	Jah Hut
JAI	GT	L	Jacalteco, Western
JAJ	SB	L	Zazao
JAK	MY	L	Jakun
JAL	ID	L	Yalahatan
JAM	JM	L	Southwestern Caribbean Creole English
JAN	ID	L	Javanese
JAO	AU	L	Yanyuwa
JAP	BR	L	Jaruára
JAQ	ID	L	Yaqay
JAR	NG	L	Jarawa
JAS	NC	L	Javanese, New Caledonian
JAT	UA	L	Jakati
JAU	ID	L	Yaur
JAV	PK	L	Jadgali
JAX	ID	L	Malay, Jambi
JAY	AU	N	Jarnango
JAZ	NC	L	Jawe
JBE	IL	L	Judeo-berber
JBJ	ID	L	Arandai
JBN	LY	L	Nafusi
JBT	BR	N	Jabutí
JBU	NG	L	Jukun Takum
JCS	JM	L	Jamaican Country Sign Language
JCT	UZ	N	Judeo-crimean Tatar
JEB	PE	L	Jebero
JEE	NP	L	Jerung
JEG	LA	L	Jeng
JEH	VN	L	Jeh
JEI	ID	L	Yei
JEL	ID	L	Yelmek
JEN	NG	L	Dza
JER	NG	L	Jere
JET	PG	L	Manem
JEU	TD	L	Jonkor Bourmataguil
JGE	IL	L	Judeo-georgian
JHI	MY	L	Jehai
JIA	CM	L	Jina
JIB	NG	L	Jibu
JIC	HN	L	Tol
JID	NG	L	Bu
JIE	NG	L	Jilbe
JIG	AU	N	Djingili
JIH	CN	L	Shangzhai
JII	SO	L	Jiiddu
JIJ	TZ	L	Jiji
JIL	PG	L	Jilim
JIM	CM	L	Jimi
JIN	TZ	L	Zinza
JIO	CN	L	Jiamao
JIQ	CN	L	Guanyinqiao
JIT	TZ	L	Jita
JIU	CN	L	Jinuo, Youle
JIV	EC	L	Shuar
JIY	CN	L	Jinuo, Buyuan
JKO	PG	L	Kubo
JKU	NG	L	Labir
JMA	PG	L	Jimajima
JMB	NG	L	Zumbun
JMC	TZ	L	Machambe
JMD	ID	L	Yamdena
JMI	NG	L	Jimi
JMK	SE	L	Jamska
JMR	GH	L	Kamara
JMS	NG	L	Mashi
JMX	MX	L	Mixteco, Juxtlahuaca Oeste
JNA	IN	L	Jangshung
JND	PK	L	Jandavra
JNG	AU	N	Yangman
JNI	NG	L	Janji
JNJ	ET	L	Yemsa
JNL	NP	L	Rawat
JNS	IN	L	Jaunsari
JOB	ZR	L	Joba
JOD	CI	L	Jula, Odienné
JOR	BO	E	Jorá
JOS	JO	L	Jordanian Sign Language
JOW	ML	L	Jowulu
JPN	JP	L	Japanese
JQR	PE	L	Jaqaru
JRA	VN	L	Jarai
JRR	NG	L	Jiru
JRT	NG	L	Jorto
JRU	VE	L	Japrería
JSL	JP	L	Japanese Sign Language
JUA	BR	N	Júma
JUB	NG	L	Wannu
JUC	CN	E	Jurchen
JUD	CI	L	Jula, Worodougou
JUK	NG	L	Wapan
JUL	NP	L	Jirel
JUM	SD	L	Jumjum
JUN	IN	L	Juang
JUO	NG	L	Kona
JUP	BR	L	Hupdë
JUR	BR	L	Jurúna
JUT	DK	L	Jutish
JUU	NG	L	Ju
JUW	NG	L	Wase
JUY	IN	L	Juray
JVN	SR	L	Javanese, Caribbean
JWI	GH	L	Jwira-pepesa
JYA	CN	L	Jiarong
JYE	IL	L	Arabic, Judeo-yemeni
JYY	TD	L	Jaya
KAA	US	N	Kansa
KAB	RU	L	Kabardian
KAC	UZ	L	Karakalpak
KAD	NG	L	Kadara
KAE	TW	E	Ketangalan
KAF	TZ	L	Chagga
KAG	MY	L	Kajaman
KAH	CF	L	Kara
KAI	NG	L	Karekare
KAJ	NG	L	Jju
KAK	PH	L	Kallahan, Kayapa
KAL	US	N	Kalapuya
KAM	NG	L	Tsishingini
KAN	PH	L	Kankanay, Northern
KAO	ML	L	Xaasongaxango
KAP	RU	L	Bezhta
KAQ	PE	L	Capanahua
KAR	BF	L	Karaboro, Eastern
KAS	BF	L	Kasem
KAT	SD	L	Katcha-kadugli-miri
KAU	NG	L	Cinda-regi-tiyal
KAV	BR	N	Katukína
KAW	US	N	Kawaiisu
KAX	ID	L	Kao
KAY	BR	L	Kamayurá
KAZ	KZ	L	Kazakh
KBA	AU	E	Kalarko
KBB	BR	L	Kaxuiâna
KBC	BR	L	Kadiwéu
KBD	BR	L	Kabixí
KBE	AU	N	Kanju
KBF	CL	E	Kakauhua
KBH	CO	L	Camsá
KBI	ZR	L	Kango
KBJ	ZR	L	Kari
KBK	PG	L	Koiari, Grass
KBL	TD	L	Kanembu
KBM	PG	L	Iwal
KBN	CF	L	Kare
KBO	SD	L	Keliko
KBP	TG	L	Kabiyé
KBQ	PG	L	Kamano
KBR	ET	L	Kaficho
KBS	GA	L	Kande
KBT	PG	L	Kabadi
KBU	PK	L	Kabutra
KBV	ID	L	Kamberataro
KBW	PG	L	Kaiep
KBX	PG	L	Ap Ma
KBY	NE	L	Kanuri, Manga
KBZ	NG	L	Duhwa
KCA	RU	L	Khanty
KCB	PG	N	Kawacha
KCC	NG	L	Lubila
KCD	ID	L	Kanum, Ngkâlmpw
KCE	NG	L	Kaivi
KCF	NG	L	Ukaan
KCG	NG	L	Tyap
KCH	NG	L	Vono
KCI	NG	L	Kamantan
KCJ	GW	L	Kobiana
KCK	BW	L	Kalanga
KCL	PG	L	Kela
KCM	CF	L	Gula
KCN	UG	L	Nubi
KCO	PG	L	Kinalakna
KCP	SD	L	Kanga
KCQ	NG	L	Kamo
KCR	SD	L	Katla
KCS	NG	L	Koenoem
KCT	PG	L	Kaian
KCU	TZ	L	Kami
KCV	ZR	L	Kete
KCW	ZR	L	Kabwari
KCX	ET	L	Kachama-ganjule
KCY	DZ	L	Korandje
KCZ	TZ	L	Konongo
KDA	AU	E	Worimi
KDB	IQ	L	Kurdi
KDC	TZ	L	Kutu
KDD	AU	L	Yankunytjatjara
KDE	TZ	L	Makonde
KDF	PG	L	Mamusi
KDG	ZR	L	Seba
KDH	TG	L	Tem
KDI	UG	L	Kumam
KDJ	UG	L	Karamojong
KDK	NC	L	Numee
KDL	NG	L	Tsikimba
KDM	NG	L	Kagoma
KDN	ZW	L	Kunda
KDO	KG	L	Kirghiz
KDP	NG	L	Kaningdon-nindem
KDQ	IN	L	Koch
KDR	LT	L	Karaim
KDS	LA	L	Lahu Shi
KDT	TH	L	Kuy
KDU	SD	L	Kadaru
KDV	MM	L	Kado
KDW	ID	L	Koneraw
KDX	NG	L	Kam
KDY	ID	L	Keder
KDZ	CM	L	Kwaja
KEA	CV	L	Kabuverdianu
KEB	GA	L	Kili
KEC	SD	L	Keiga
KED	TZ	L	Kerebe
KEE	US	L	Keres, Eastern
KEF	TG	L	Kpessi
KEG	SD	L	Tese
KEH	NG	L	Khana
KEI	ID	L	Kei
KEJ	IN	L	Kadar
KEK	GT	L	Kekchí
KEL	ZR	L	Kela
KEM	TP	L	Kemak
KEN	CM	L	Kenyang
KEO	UG	L	Kakwa
KEP	IN	L	Kaikadi
KEQ	IN	L	Kamar
KER	TD	L	Kera
KES	NG	L	Kugbo
KET	RU	L	Ket
KEU	TG	L	Akebou
KEV	IN	L	Kanikkaran
KEW	PG	L	Kewa, West
KEX	IN	L	Kukna
KEY	IN	L	Kupia
KEZ	NG	L	Kukele
KFA	IN	L	Kodagu
KFB	IN	L	Kolami, Northwestern
KFC	IN	L	Konda-dora
KFD	IN	L	Koraga, Korra
KFE	IN	L	Kota
KFF	IN	L	Koya
KFG	IN	L	Kudiya
KFH	IN	L	Kurichiya
KFI	IN	L	Kurumba
KFJ	CN	L	Kemiehua
KFK	IN	L	Kinnauri
KFM	IR	L	Khunsari
KFO	CI	L	Jula, Koro
KFP	IN	L	Korwa
KFQ	IN	L	Korku
KFR	IN	L	Kachchi
KFS	IN	L	Bilaspuri
KFT	IN	L	Kanjari
KFU	IN	L	Katkari
KFX	IN	L	Pahari, Kullu
KFY	IN	L	Kumauni
KFZ	BF	L	Koromfé
KGA	CI	L	Jula, Koyaga
KGB	ID	L	Kawe
KGC	LA	L	Kasseng
KGD	LA	L	Kataang
KGE	ID	L	Komering
KGF	PG	L	Kube
KGG	NP	E	Kusunda
KGH	PH	L	Kalinga, Upper Tanudan
KGI	MY	L	Kuala Lumpur Sign Language
KGJ	NP	L	Kham, Gamale
KGK	BR	L	Kaiwá
KGL	AU	N	Kunggari
KGM	BR	E	Karipúna
KGN	IR	L	Karingani
KGO	SD	L	Krongo
KGP	BR	L	Kaingáng
KGQ	ID	L	Kamoro
KGR	ID	L	Abun
KGS	AU	N	Kumbainggar
KGT	NG	L	Somyewe
KGU	ID	L	Kombai
KGV	ID	L	Karas
KGW	ID	L	Karon Dori
KGX	ID	L	Kamaru
KGY	NP	L	Kyerung
KGZ	RU	L	Kalmyk-oirat
KHA	SL	L	Kuranko
KHB	CN	L	Lü
KHC	ID	L	Tukangbesi North
KHD	ID	N	Kanum, Bädi
KHE	ID	L	Korowai
KHF	LA	L	Khuen
KHG	CN	L	Khams
KHH	ID	L	Kehu
KHI	IN	L	Khasi
KHJ	NG	L	Kuturmi
KHK	MN	L	Mongolian, Halh
KHL	PG	L	Lusi
KHM	PG	L	Kamula
KHN	IN	L	Khandesi
KHO	TD	L	Kuo
KHP	ID	L	Kapori
KHQ	ML	L	Songhay, Koyra Chiini
KHR	IN	L	Kharia
KHS	PG	L	Kasua
KHT	MM	L	Khamti
KHU	AO	L	Nkhumbi
KHV	RU	L	Khvarshi
KHW	PK	L	Khowar
KHX	ZR	L	Kanu
KHY	ZR	L	Kele
KHZ	PG	L	Keopara
KIA	TD	L	Kim
KIB	SD	L	Koalib
KIC	US	L	Kickapoo
KID	CM	L	Koskin
KIE	TD	L	Kibet
KIF	NP	L	Kham, Nisi
KIG	ID	L	Kimaama
KIH	PG	L	Kilmeri
KII	US	E	Kitsai
KIJ	PG	L	Kilivila
KIK	KE	L	Kamba
KIL	NG	L	Kariya
KIM	RU	L	Karagas
KIN	ID	L	Ketengban
KIO	US	L	Kiowa
KIP	NP	L	Kham, Sheshi
KIQ	ID	L	Kosadle
KIR	NG	L	Huba
KIS	PG	L	Kis
KIT	PG	L	Agob
KIU	KE	L	Gikuyu
KIV	TZ	L	Kimbu
KIW	PG	L	Kiwai, Northeast
KIX	TZ	L	Kinga
KIY	ID	L	Kirikiri
KIZ	TZ	L	Kisi
KJA	ID	L	Mlap
KJB	GT	L	Kanjobal, Eastern
KJC	ID	L	Konjo, Coastal
KJD	PG	L	Kiwai, Southern
KJE	ID	L	Kisar
KJF	IR	L	Khalaj
KJG	LA	L	Khmu
KJH	RU	L	Khakas
KJI	SB	L	Zabana
KJJ	AZ	L	Khinalugh
KJK	ID	L	Konjo, Highland
KJL	NP	L	Kham, Takale
KJM	VN	L	Khang
KJN	AU	L	Kunjen
KJO	IN	L	Kinnauri, Harijan
KJP	MM	L	Karen, Pwo Eastern
KJQ	US	L	Keres, Western
KJR	ID	L	Kurudu
KJS	PG	L	Kewa, East
KJT	TH	L	Karen, Pwo, Phrae
KJU	US	N	Kashaya
KJV	IN	L	Kannada
KJW	ID	L	Kwandang
KJX	PG	L	Kereaka
KJY	PG	L	Erave
KJZ	BT	L	Bumthangkha
KKA	NG	L	Kakanda
KKB	ID	N	Kwerisa
KKC	PG	L	Odoodee
KKD	NG	L	Kinuku
KKF	VN	L	Gelao
KKG	PH	L	Kalinga, Mabaka Valley
KKH	MM	L	Khün
KKI	TZ	L	Kagulu
KKJ	CM	L	Kako
KKK	SB	L	Kokota
KKL	ID	L	Yale, Kosarek
KKM	NG	N	Kiong
KKN	KR	L	Korean
KKO	SD	L	Karko
KKP	AU	L	Gugubera
KKQ	ZR	L	Kaiku
KKR	NG	L	Kir-balar
KKS	NG	L	Giiwo
KKT	NP	L	Koi
KKU	NG	L	Tumi
KKV	ID	L	Kangean
KKW	CG	L	Teke, Southern
KKY	AU	L	Guguyimidjir
KKZ	CA	L	Kaska
KLA	US	N	Klamath-modoc
KLB	MX	N	Kiliwa
KLC	CM	L	Kolbila
KLD	AU	N	Kamilaroi
KLE	NP	L	Kulung
KLF	TD	L	Kendeje
KLG	PH	L	Kalagan, Tagakaulu
KLH	PG	L	Weliki
KLI	ID	L	Kalumpang
KLJ	IR	L	Khalaj
KLK	NG	L	Kono
KLL	PH	L	Kalagan, Kagan
KLM	PG	L	Kolom
KLN	KE	L	Kalenjin
KLO	NG	L	Kapya
KLP	PG	N	Kamasa
KLQ	PG	L	Rumu
KLR	NP	L	Khaling
KLS	PK	L	Kalasha
KLT	PG	L	Komutu
KLU	LR	L	Klao
KLV	VU	L	Maskelynes
KLW	ID	L	Lindu
KLX	PG	L	Koluawawa
KLY	ID	L	Kalao
KLZ	ID	L	Kabola
KMA	GH	L	Konni
KMB	CM	L	Gimnime
KMC	CN	L	Dong, Southern
KMD	PH	L	Kalinga, Madukayang
KME	CM	L	Bakole
KMF	PG	L	Kare
KMG	PG	L	Kâte
KMH	PG	L	Kalam
KMI	NG	L	Kami
KMJ	IN	L	Kumarbhag Paharia
KMK	PH	L	Kalinga, Limos
KML	PH	L	Kalinga, Lower Tanudan
KMM	IN	L	Kom
KMN	PG	L	Awtuw
KMO	PG	L	Kwoma
KMP	CM	L	Gimme
KMQ	ET	L	Kwama
KMR	KH	L	Khmer, Central
KMS	PG	L	Kamasau
KMT	ID	L	Kemtuik
KMU	PG	L	Kanite
KMV	BR	L	Karipúna Creole French
KMW	ZR	L	Komo
KMX	PG	L	Wabuda
KMY	NG	L	Koma
KMZ	IR	L	Khorasani Turkish
KNA	NG	L	Dera
KNB	PH	L	Kalinga, Lubuagan
KNC	SD	L	Kenuzi-dongola
KND	ID	L	Konda
KNE	PH	L	Kankanaey
KNF	CG	L	Kunyi
KNG	TW	E	Kulun
KNH	ID	L	Kenyah, Kayan River
KNI	NG	L	Kanufi
KNJ	GT	L	Kanjobal, Western
KNK	IN	L	Konkani
KNL	ID	L	Keninjal
KNM	BR	L	Kanamarí
KNN	CN	L	Chinese, Gan
KNO	SL	L	Kono
KNP	CM	L	Kwanja
KNQ	MY	L	Kintaq
KNR	PG	L	Kaningra
KNS	MY	L	Kensiu
KNT	BR	L	Katukína, Panoan
KNV	PG	L	Tabo
KNW	NA	L	Kung-ekoka
KNX	ID	L	Kendayan
KNY	ZR	L	Kanyok
KNZ	BF	L	Kalamsé
KOA	PG	L	Konomala
KOB	BR	L	Kohoroxitari
KOC	NG	E	Kpati
KOD	ID	L	Kodi
KOE	SD	L	Kacipo-balesi
KOF	NG	E	Kubi
KOG	CO	L	Cogui
KOH	CG	L	Koyo
KOI	RU	L	Komi-permyak
KOJ	CF	L	Sara Dunjo
KOK	PG	L	Kombio
KOL	PG	L	Kol
KOM	SD	L	Komo
KON	ZR	L	Kongo
KOO	UG	L	Konjo
KOP	PG	L	Kwato
KOQ	GA	L	Kota
KOR	DE	L	Kölsch
KOS	GH	L	Konkomba
KOT	CM	L	Lagwan
KOU	TD	L	Koke
KOV	NG	L	Kudu-camo
KOW	NG	L	Kugama
KOX	CO	E	Coxima
KOY	US	N	Koyukon
KOZ	PG	L	Korak
KPA	NG	L	Kutto
KPB	IN	L	Kurumba, Mullu
KPC	CO	L	Curripaco
KPD	ID	L	Koba
KPE	LR	L	Kpelle, Liberia
KPF	PG	L	Komba
KPG	FM	L	Kapingamarangi
KPH	NG	L	Kanuri, Central
KPI	ID	L	Kofei
KPJ	BR	L	Karajá
KPK	NG	L	Kpan
KPL	ZR	L	Kpala
KPM	VN	L	Koho
KPO	TG	L	Akposo
KPP	MM	L	Karen, Paku
KPQ	ID	L	Korupun-sela
KPR	PG	L	Korafe
KPS	ID	L	Tehit
KPT	RU	L	Karata
KPU	ID	L	Kafoa
KPV	RU	L	Komi-zyrian
KPW	PG	L	Kobon
KPX	PG	L	Koiali, Mountain
KPY	RU	L	Koryak
KPZ	UG	L	Kupsabiny
KQA	PG	L	Mum
KQB	PG	L	Kovai
KQC	PG	L	Doromu
KQD	IQ	L	Koy Sanjaq Surat
KQE	PH	L	Kalagan
KQF	PG	L	Kakabai
KQG	BF	L	Khe
KQH	TZ	L	Kisankasa
KQI	PG	L	Koitabu
KQJ	PG	L	Koromira
KQK	BJ	L	Ko-gbe
KQL	PG	L	Kyenele
KQM	CI	L	Khisa
KQN	ZM	L	Kaonde
KQO	LR	L	Krahn, Eastern
KQP	TD	L	Kimré
KQQ	BR	L	Krenak
KQR	MY	L	Kimaragang
KQS	GN	L	Kissi, Northern
KQT	MY	L	Kadazan, Klias River
KQU	ZA	E	Seroa
KQV	MY	L	Okolod
KQW	PG	L	Kandas
KQX	CM	L	Mser
KQY	ET	L	Koorete
KQZ	ZA	L	Korana
KRA	NP	L	Kumhali
KRB	US	E	Karkin
KRC	RU	L	Karachay-balkar
KRD	TP	L	Kairui-midiki
KRE	BR	L	Kreen-akarore
KRF	VU	L	Koro
KRG	ID	L	Korowai, North
KRH	NG	L	Kurama
KRI	SL	L	Krio
KRJ	PH	L	Kinaray-a
KRK	RU	N	Kerek
KRL	RU	L	Karelian
KRM	SL	L	Krim
KRN	LR	L	Sapo
KRO	PG	L	Krisa
KRP	NG	L	Korop
KRQ	ID	L	Krui
KRR	KH	L	Kru'ng 2
KRS	SD	L	Gbaya
KRT	NE	L	Kanuri, Tumari
KRU	LR	L	Tajuasohn
KRV	KH	L	Kravet
KRW	LR	L	Krahn, Western
KRX	SN	L	Karon
KRY	AZ	L	Kryts
KRZ	ID	L	Kanum, Sota
KSA	NG	L	Shuwa-zamani
KSB	TZ	L	Shambala
KSC	PH	L	Kalinga, Southern
KSD	PG	L	Kuanua
KSE	PG	L	Kuni
KSF	CM	L	Bafia
KSG	SB	L	Kusaghe
KSH	IN	L	Kashmiri
KSI	FM	L	Kosraean
KSJ	PG	L	Uare
KSK	RU	L	Kumyk
KSL	PG	L	Kumalu
KSM	NG	L	Kumba
KSN	PH	L	Kasiguranin
KSO	NG	L	Kofa
KSP	CF	L	Kaba
KSQ	NG	L	Kwaami
KSR	PG	L	Kosorong
KSS	LR	L	Kisi, Southern
KST	BF	L	Winyé
KSU	IN	N	Khamyang
KSV	ZR	L	Kusu
KSW	MM	L	Karen, S'gaw
KSX	ID	L	Kedang
KSY	IN	L	Kharia Thar
KSZ	IN	L	Koraku
KTA	VN	L	Katua
KTB	ET	L	Kambaata
KTC	NG	L	Kholok
KTD	AU	N	Kokata
KTE	NP	L	Nubri
KTF	ZR	L	Kwami
KTG	AU	E	Kalkutung
KTH	TD	L	Karanga
KTJ	CI	L	Krumen, Plapo
KTK	PG	E	Kaniet
KTL	IR	L	Koroshi
KTM	PG	L	Kurti
KTN	BR	L	Karitiâna
KTO	PG	L	Kuot
KTP	LA	L	Kaduo
KTQ	PH	E	Katabaga
KTR	MY	L	Kota Marudu Tinagas
KTU	ZR	L	Kituba
KTV	VN	L	Katu, Eastern
KTW	US	N	Kato
KTX	BR	L	Kaxararí
KTY	ZR	L	Kango
KTZ	BW	L	Ju/'hoan
KUA	CO	L	Kuna, Border
KUB	NG	L	Kutep
KUC	CA	L	Gwich'in
KUD	PG	L	'Auhelawa
KUE	PG	L	Kuman
KUF	LA	L	Katu, Western
KUG	NG	L	Kupa
KUH	NG	L	Kushi
KUI	BR	L	Kuikúro-kalapálo
KUJ	TZ	L	Kuria
KUK	ID	L	Kepo'
KUL	NG	L	Kulere
KUM	ER	L	Kunama
KUN	CA	L	Kutenai
KUO	PG	L	Kumukio
KUP	PG	L	Kunimaipa
KUQ	BR	L	Karipuná
KUR	TR	L	Kurmanji
KUS	GH	L	Kusaal
KUT	CM	L	Peere
KUU	US	L	Kuskokwim, Upper
KUV	ID	L	Kur
KUW	CF	L	Kpagua
KUX	AU	L	Kukatja
KUY	AO	L	Kwanyama
KUZ	CL	E	Kunza
KVA	RU	L	Bagvalal
KVB	ID	L	Kubu
KVC	PG	L	Kove
KVD	ID	L	Kui
KVE	MY	L	Kalabakan
KVF	TD	L	Kabalai
KVG	PG	L	Boazi
KVH	ID	L	Komodo
KVI	TD	L	Kwang
KVJ	CM	L	Psikye
KVK	KR	L	Korean Sign Language
KVL	MM	L	Karen, Brek
KVM	CM	L	Kendem
KVN	IN	L	Kurux
KVO	ID	L	Dobel
KVP	ID	L	Kompane
KVQ	MM	L	Karen, Geba
KVR	ID	L	Kerinci
KVS	AU	N	Kunggara
KVT	MM	L	Karen, Lahta
KVU	MM	L	Karen, Yinbaw
KVV	ID	L	Kola
KVW	ID	L	Wersing
KVX	PK	L	Koli, Parkari
KVY	MM	L	Karen, Yintale
KVZ	ID	L	Tsakwambo
KWA	BR	L	Kamã
KWB	NG	L	Kwa
KWC	CG	L	Likwala
KWD	SB	L	Kwaio
KWE	ID	L	Kwerba
KWF	SB	L	Kwara'ae
KWG	TD	L	Kaba Deme
KWH	ID	L	Kowiai
KWI	CO	L	Awa-cuaiquer
KWK	CA	L	Kwakiutl
KWL	NG	L	Kofyar
KWM	NA	L	Kwambi
KWN	NA	L	Kwangali
KWO	PG	L	Kwomtari
KWP	CI	L	Kodia
KWQ	NG	L	Kwak
KWR	ID	L	Kwer
KWS	ZR	L	Kwese
KWT	ID	L	Kwesten
KWU	CM	L	Kwakum
KWV	TD	L	Kaba Na
KWW	SR	L	Kwinti
KWX	IN	L	Khirwar
KWY	ZR	L	Kongo, San Salvador
KWZ	AO	E	Kwadi
KXA	PG	L	Kairiru
KXB	CI	L	Krobu
KXC	ET	L	Komso
KXD	BN	L	Brunei
KXE	NG	L	Kakihum
KXF	MM	L	Karen, Manumanaw
KXG	ID	L	Katingan
KXH	ET	L	Karo
KXI	MY	L	Keningau Murut
KXJ	TD	L	Kulfa
KXK	MM	L	Karen, Zayein
KXL	NP	L	Kurux, Nepali
KXM	TH	L	Khmer, Northern
KXN	MY	L	Kanowit
KXO	BR	E	Kanoé
KXP	PK	L	Koli, Wadiyara
KXQ	ID	L	Kanum, Smärky
KXR	PG	L	Koro
KXT	PG	L	Koiwat
KXU	IN	L	Kui
KXV	IN	L	Kuvi
KXW	PG	L	Konai
KXX	CG	L	Likuba
KXY	VN	L	Kayong
KXZ	PG	L	Kerewo
KYA	TZ	L	Kwaya
KYB	PH	L	Kalinga, Butbut
KYC	PG	L	Kyaka
KYD	ID	L	Karey
KYE	GH	L	Krache
KYF	CI	L	Kouya
KYG	PG	L	Keyagana
KYH	US	L	Karok
KYI	MY	L	Kiput
KYJ	PH	L	Karao
KYK	PH	L	Kamayo
KYL	DZ	L	Kabyle
KYM	CF	L	Kpatili
KYN	PH	L	Karolanos
KYO	ID	L	Kelon
KYP	LA	L	Kang
KYQ	TD	L	Kenga
KYR	BR	L	Kuruáya
KYS	MY	L	Kayan, Baram
KYT	ID	L	Kayagar
KYU	MM	L	Kayah, Western
KYV	NP	L	Kayort
KYW	IN	L	Kudmali
KYX	PG	L	Rapoisi
KYY	PG	L	Kambaira
KYZ	BR	L	Kayabí
KZA	BF	L	Karaboro, Western
KZB	ID	L	Kaibobo
KZC	CI	L	Kulango, Bondoukou
KZD	ID	L	Kadai
KZE	PG	L	Kosena
KZF	ID	L	Kaili, Da'a
KZG	JP	L	Kikai
KZH	ID	L	Mandobo
KZI	MY	L	Kelabit
KZJ	MY	L	Kadazan, Coastal
KZK	SB	E	Kazukuru
KZL	ID	N	Kayeli
KZM	ID	L	Kais
KZN	MW	L	Kokola
KZO	GA	L	Kaningi
KZP	ID	L	Kaidipang
KZQ	NP	L	Kaike
KZR	CM	L	Karang
KZS	MY	L	Dusun, Sugut
KZT	MY	L	Dusun, Tambunan
KZU	ID	L	Kayupulau
KZW	BR	E	Kariri-xocó
KZX	ID	N	Kamarian
KZY	ZR	L	Kango
KZZ	ID	L	Kalabra
LAA	PH	L	Subanun, Lapuyan
LAB	ZM	L	Lamba
LAC	MX	L	Lacandón
LAD	ID	L	Laha
LAE	IN	L	Pattani
LAF	SD	L	Lafofa
LAG	TZ	L	Rangi
LAH	CN	L	Lahu
LAI	TZ	L	Lambya
LAJ	UG	L	Lango
LAK	NG	L	Laka
LAL	ZR	L	Lalia
LAM	TD	L	Laka
LAN	NG	L	Laru
LAO	GN	L	Landoma
LAP	UG	L	Ganda
LAQ	VN	L	Laqua
LAR	GH	L	Larteh
LAS	TG	L	Lama
LAT	LV	L	Latvian
LAU	ID	L	Laba
LAV	ZM	L	Luyana
LAW	ID	L	Lauje
LAX	IN	L	Lalung
LAY	MM	L	Lama
LAZ	PG	E	Aribwatsa
LBA	MM	L	Lui
LBB	PG	L	Label
LBC	CN	L	Lakkia
LBE	RU	L	Lak
LBF	IN	L	Tinani
LBG	MM	L	Laopang
LBI	CM	L	La'bi
LBJ	IN	L	Ladakhi
LBM	IN	L	Lodhi
LBN	LA	L	Lamet
LBO	LA	L	Laven
LBQ	PG	L	Wampar
LBR	NP	L	Lorung, Northern
LBS	LY	L	Libyan Sign Language
LBT	VN	L	Lachi
LBU	PG	L	Labu
LBV	PG	L	Lavatbura-lamusong
LBW	ID	L	Tolaki
LBX	ID	L	Lawangan
LBY	AU	N	Lamu-lamu
LBZ	AU	N	Lardil
LCC	ID	L	Legenyem
LCD	ID	L	Lola
LCE	ID	L	Loncong
LCF	ID	L	Lubu
LCH	AO	L	Luchazi
LCL	ID	L	Lisela
LCM	PG	L	Tungag
LCP	CN	L	Lawa, Western
LCQ	ID	L	Luhu
LCS	ID	L	Lisabata-nuniali
LDB	NG	L	Idun
LDD	NG	L	Luri
LDG	NG	L	Lenyima
LDH	NG	L	Lamja-dengsa-tola
LDJ	NG	L	Lemoro
LDK	NG	L	Leelau
LDL	NG	L	Kaan
LDO	NG	L	Loo
LDP	NG	L	Tso
LDQ	NG	N	Lufu
LEA	ZR	L	Lega-shabunda
LEB	ZM	L	Lala-bisa
LEC	BO	N	Leco
LED	ZR	L	Lendu
LEE	BF	L	Lyélé
LEF	GH	L	Lelemi
LEG	PY	L	Lengua
LEH	ZM	L	Lenje
LEI	PG	L	Lemio
LEJ	ZR	L	Lengola
LEK	PG	L	Leipon
LEL	ZR	L	Lele
LEM	CM	L	Nomaande
LEN	HN	N	Lenca
LEO	CM	L	Leti
LEP	IN	L	Lepcha
LEQ	PG	L	Lembena
LER	PG	L	Lenkau
LES	ZR	L	Lese
LET	PG	L	Lesing-gelimi
LEU	PG	L	Kara
LEV	ID	L	Lamma
LEW	ID	L	Kaili, Ledo
LEX	ID	L	Luang
LEY	ID	L	Lemolang
LEZ	RU	L	Lezgi
LGA	SB	L	Lungga
LGB	SB	N	Laghu
LGH	VN	L	Laghuu
LGI	ID	N	Lengilu
LGK	VU	L	Lingarak
LGL	SB	L	Langalanga
LGM	ZR	L	Lega-mwenga
LGN	ET	L	Opuuo
LGQ	GH	L	Logba
LGR	SB	L	Lengo
LGT	PG	L	Pahi
LGU	SB	L	Longgu
LGZ	ZR	L	Ligenza
LHA	VN	L	Laha
LHL	IN	L	Lohar, Lahul
LHM	NP	L	Lhomi
LHN	MY	L	Lahanan
LHP	BT	L	Lhokpu
LHT	VU	L	Toga
LIA	SL	L	Limba, West-central
LIB	PG	L	Likum
LIC	CN	L	Hlai
LID	PG	L	Nyindrou
LIE	ZR	L	Likila
LIF	NP	L	Limbu
LIG	GH	L	Ligbi
LIH	PG	L	Lihir
LII	NP	N	Lingkhim
LIJ	IT	L	Ligurian
LIK	ZR	L	Lika
LIL	CA	L	Lillooet
LIM	CM	L	Limbum
LIN	ZR	L	Lingala
LIO	ID	L	Liki
LIP	GH	L	Sekpele
LIQ	ET	L	Libido
LIR	LR	L	Liberian English
LIS	CN	L	Lisu
LIT	LT	L	Lithuanian
LIU	SD	L	Logorik
LIV	LV	L	Liv
LIW	ID	L	Lembak
LIX	ID	L	Liabuku
LIY	CF	L	Banda-bambari
LIZ	ZR	L	Libinza
LJE	ID	L	Rampi
LJI	ID	L	Laiyolo
LJL	ID	L	Li'o
LJO	ID	L	Limboto
LJP	ID	L	Lampung
LKA	TP	L	Lakalei
LKE	UG	L	Kenyi
LKH	BT	L	Lakha
LKL	PG	L	Laeko-libuat
LKN	VU	L	Lakona
LKR	SD	L	Päri
LKS	FI	E	Saami, Kemi
LKT	US	L	Lakota
LKY	SD	L	Lokoya
LLA	NG	L	Lala-roba
LLB	MZ	L	Lolo
LLC	GN	L	Lele
LLD	IT	L	Ladin
LLF	PG	E	Hermit
LLK	MY	L	Lelak
LLL	PG	L	Lilau
LLM	ID	L	Lasalimu
LLN	TD	L	Lele
LLO	LA	L	Khlor
LLP	VU	L	Efate, North
LLQ	ID	L	Lolak
LLS	LT	L	Lithuanian Sign Language
LLU	SB	L	Lau
LLX	FJ	L	Lauan
LMA	GN	L	Limba, East
LMB	VU	L	Merei
LMC	AU	N	Limilngan
LMD	SD	L	Lumun
LME	TD	L	Pévé
LMF	ID	L	Lembata, South
LMG	PG	L	Lamogai
LMH	NP	L	Lambichhong
LMI	ZR	L	Lombi
LMJ	ID	L	Lembata, West
LMK	IN	L	Lamkang
LML	VU	L	Hano
LMM	KH	L	Lamam
LMN	IN	L	Lambadi
LMO	IT	L	Lombard
LMQ	ID	L	Lamatuka
LMR	ID	L	Lamalera
LMS	FR	L	Limousin
LMT	ID	L	Lematang
LMU	VU	L	Lamenu
LMV	FJ	L	Lomaiviti
LMW	US	N	Miwok, Lake
LMX	CM	L	Laimbue
LMY	ID	L	Lamboya
LNA	CF	L	Langbashe
LNB	NA	L	Mbalanhu
LNC	FR	L	Languedocien
LND	ID	L	Lundayeh
LNH	MY	L	Lanoh
LNI	PG	L	Lantanai
LNJ	AU	E	Leningitij
LNL	CF	L	Banda, South Central
LNM	PG	L	Langam
LNN	VU	L	Lorediakarkar
LNO	SD	L	Lango
LNT	ID	L	Lintang
LNU	NG	L	Longuda
LNZ	ZR	L	Lonzo
LOA	PG	L	Lukep
LOB	BF	L	Lobi
LOC	PH	L	Inonhan
LOD	MY	L	Berawan
LOE	ID	L	Saluan, Coastal
LOF	SD	L	Logol
LOG	ZR	L	Logo
LOH	SD	L	Longarim
LOI	CI	L	Loma
LOJ	PG	L	Lou
LOK	SL	L	Loko
LOL	ID	L	Loloda
LOM	LR	L	Loma
LOO	ZR	L	Lombo
LOP	NG	L	Lopa
LOQ	ZR	L	Lobala
LOR	CI	L	Tèèn
LOS	PG	L	Loniu
LOT	SD	L	Otuho
LOU	US	L	Louisiana Creole French
LOV	MM	L	Lopi
LOW	MY	L	Lobu, Tampias
LOX	ID	N	Loun
LOY	NP	L	Lopa
LOZ	ZM	L	Lozi
LPA	VU	L	Lelepa
LPB	SE	N	Saami, Pite
LPC	SE	L	Saami, Southern
LPD	RU	L	Saami, Kildin
LPE	ID	L	Lepki
LPI	FI	L	Saami, Inari
LPK	FI	L	Saami, Skolt
LPL	SE	L	Saami, Lule
LPR	NO	L	Saami, Northern
LPT	RU	N	Saami, Ter
LPU	SE	L	Saami, Ume
LPX	SD	L	Loppit
LRA	ID	L	Lara'
LRE	CA	E	Laurentian
LRG	AU	N	Laragia
LRI	IR	L	Luri
LRK	PK	L	Loarki
LRL	IR	L	Lari
LRN	ID	L	Lorang
LRO	SD	L	Laro
LRR	NP	L	Lorung, Southern
LRV	VU	L	Larevat
LSA	IR	L	Lasgerdi
LSD	IL	L	Lishana Deni
LSG	FR	L	Lyons Sign Language
LSH	IN	L	Lushai
LSI	MM	L	Lashi
LSL	LV	L	Latvian Sign Language
LSO	LA	L	Laos Sign Language
LSR	PG	L	Aruop
LSS	PK	L	Lasi
LTI	ID	L	Leti
LTN	VA	E	Latin
LTU	ID	L	Latu
LTZ	VU	L	Litzlitz
LUA	US	E	Lumbee
LUB	ZR	L	Luba-kasai
LUC	UG	L	Aringa
LUD	RU	L	Ludian
LUE	ZM	L	Luvale
LUF	PG	N	Laua
LUG	UG	L	Lugbara
LUH	ZR	L	Luba-katanga
LUI	US	L	Luiseño
LUJ	ZR	L	Luna
LUK	BT	L	Lunanakha
LUL	SD	L	Lulubo
LUM	AO	L	Luimbi
LUN	SB	L	Ontong Java
LUO	KE	L	Luo
LUP	GA	L	Lumbu
LUQ	CU	L	Lucumi
LUR	ID	L	Laura
LUS	ZR	L	Lusengo
LUT	US	N	Lushootseed
LUU	NP	L	Lumba-yakkha
LUV	OM	L	Luwati
LUW	CM	N	Luo
LUX	LU	L	Luxembourgeois
LUY	KE	L	Luyia
LVA	TP	N	Maku'a
LVK	SB	L	Lavukaleve
LVN	ZM	L	Lunda
LVU	ID	L	Levuka
LWA	ZR	L	Lwalu
LWD	PG	L	Lewada-dewara
LWE	ID	L	Lewo Eleng
LWH	VN	L	Lachi, White
LWL	TH	L	Lawa, Eastern
LWO	SD	L	Luwo
LWT	ID	L	Lewotobi
LWW	VU	L	Lewo
LYA	BT	L	Layakha
LZZ	TR	L	Laz
MAA	MX	L	Mazateco, San Jerónimo Tecóatl
MAB	MX	L	Mixteco, Yutanduchi
MAC	CA	L	Malecite-passamaquoddy
MAD	AR	L	Wichí Lhamtés Vejoz
MAE	NG	L	Bo-rukul
MAF	CM	L	Mafa
MAG	BR	L	Makuráp
MAH	NG	L	Mangas
MAI	US	N	Maidu, Northwest
MAJ	MX	L	Mazateco, Jalapa De Díaz
MAK	MZ	L	Makhuwa-meetto
MAL	RU	L	Mari, Low
MAM	GT	L	Mam, Northern
MAN	GW	L	Mankanya
MAO	MX	L	Mazateco, Ixcatlán
MAP	TD	L	Bedjond
MAQ	MX	L	Mazateco, Chiquihuitlán
MAR	NG	L	Marghi Central
MAS	SD	L	Ngile
MAT	MX	N	Matlatzinca, San Francisco De Los Ranchos
MAU	MX	L	Mazateco, Huautla
MAV	BR	L	Sateré-mawé
MAW	GH	L	Mampruli
MAX	ID	L	Malay, North Moluccan
MAY	MX	L	Mayo
MAZ	MX	L	Mazahua Central
MBA	PH	L	Higaonon
MBB	PH	L	Manobo, Western Bukidnon
MBC	GY	L	Macushi
MBD	PH	L	Manobo, Dibabawon
MBE	US	E	Molale
MBF	NZ	L	Maori
MBG	BR	L	Nambikuára, Northern
MBH	PG	L	Mangseng
MBI	PH	L	Manobo, Ilianen
MBJ	BR	L	Nadëb
MBK	PG	L	Malol
MBL	BR	L	Maxakalí
MBM	GA	L	Mbama
MBN	CO	L	Macaguán
MBO	CM	L	Mbo
MBP	CO	L	Malayo
MBQ	PG	L	Maisin
MBR	CO	L	Nukak Makú
MBS	PH	L	Manobo, Sarangani
MBT	PH	L	Manobo, Matigsalug
MBU	NG	L	Mbula-bwazza
MBV	GN	L	Mbulungish
MBW	PG	L	Maring
MBX	PG	L	Mari
MBY	PK	L	Memoni
MBZ	MX	L	Mixteco, Amoltepec
MCA	PY	L	Maca
MCB	PE	L	Machiguenga
MCC	PG	L	Mutum
MCD	PE	L	Sharanahua
MCE	MX	L	Mixteco, Itundujia
MCF	PE	L	Matsés
MCG	VE	N	Mapoyo
MCH	VE	L	Maquiritari
MCI	PG	L	Mese~
MCJ	NG	L	Mvanip
MCK	ZM	L	Mbunda
MCL	CO	E	Macaguaje
MCM	MY	L	Malaccan Creole Portuguese
MCN	TD	L	Masana
MCO	MX	L	Mixe, Coatlán
MCP	CM	L	Makaa
MCQ	PG	L	Managalasi
MCR	PG	L	Menya
MCS	CM	L	Mambai
MCT	CM	L	Mengisa
MCU	TD	L	Monogoy
MCV	PG	L	Minanibai
MCW	TD	L	Mawa
MCX	CF	L	Mpiemo
MCY	PG	L	Watut, South
MCZ	PG	L	Mawan
MDA	NG	L	Mada
MDB	PG	L	Morigi
MDC	PG	L	Male
MDD	CM	L	Mbum
MDE	TD	L	Maba
MDF	RU	L	Moksha
MDG	TD	N	Massalat
MDH	PH	L	Magindanaon
MDI	ZR	L	Mamvu
MDJ	ZR	L	Mangbetu
MDK	ZR	L	Mangbutu
MDL	MT	L	Maltese Sign Language
MDM	ZR	L	Mayogo
MDN	CF	L	Mbati
MDO	CF	L	Gbaya, Southwest
MDP	ZR	L	Mbala
MDQ	ZR	L	Mbole
MDR	PG	L	Magori
MDS	PG	L	Maria
MDT	CG	L	Mbere
MDU	CG	L	Mboko
MDW	CG	L	Mbosi
MDX	ET	L	Dizi
MDY	ET	L	Male
MDZ	BR	L	Suruí Do Pará
MEA	CM	L	Menka
MEB	PG	L	Ikobi-mena
MEC	AU	N	Mara
MED	PG	L	Melpa
MEE	PG	L	Mengen
MEF	BD	L	Megam
MEG	NC	L	Mea
MEH	MX	L	Mixteco, Tlaxiaco Suroeste
MEI	SD	L	Midob
MEJ	ID	L	Meyah
MEK	PG	L	Mekeo
MEL	MY	L	Melanau
MEM	AU	N	Mangala
MEN	CM	L	Njen
MEO	TH	L	Malay, Kedah
MEP	AU	N	Miriwung
MEQ	CM	L	Merey
MER	KE	L	Meru
MES	TD	L	Masmaje
MET	KE	L	Maasai
MEU	PG	L	Motu
MEV	LR	L	Mano
MEW	NG	L	Maaka
MEX	MG	L	Malagasy
MEY	MR	L	Hassaniyya
MEZ	US	N	Menomini
MFA	TH	L	Malay, Pattani
MFB	ID	L	Lom
MFC	ZR	L	Mba
MFD	CM	L	Mendankwe
MFE	MU	L	Morisyen
MFF	CM	L	Naki
MFG	GN	L	Mixifore
MFH	CM	L	Matal
MFI	CM	L	Wandala
MFJ	CM	L	Mefele
MFK	CM	L	Mofu, North
MFL	NG	N	Putai
MFM	NG	L	Marghi South
MFN	NG	L	Mbembe, Cross River
MFO	NG	L	Mbe
MFQ	TG	L	Moba
MFR	AU	L	Marithiel
MFS	MX	L	Mexican Sign Language
MFT	PG	L	Mokerang
MFU	AO	L	Mbwela
MFV	GW	L	Mandjak
MFW	PG	E	Mulaha
MFX	ET	L	Melo
MFY	SL	L	Mende
MFZ	SD	L	Mabaan
MGA	VN	L	Mang
MGB	TD	L	Mararit
MGC	SD	L	Morokodo
MGD	SD	L	Moru
MGE	TD	L	Mango
MGF	ID	L	Maklew
MGG	CM	L	Mpongmpong
MGH	CG	L	Mangala
MGI	NG	L	Lijili
MGJ	NG	L	Mini
MGK	ID	L	Mawes
MGL	PG	L	Maleu-kilenge
MGM	TP	L	Mambae
MGN	CF	L	Mbangi
MGO	CM	L	Meta'
MGP	NP	L	Magar, Eastern
MGQ	TZ	L	Malila
MGR	ZM	L	Mambwe-lungu
MGS	TZ	L	Manda
MGT	PG	L	Mongol
MGU	PG	L	Mailu
MGV	TZ	L	Matengo
MGW	TZ	L	Matumbi
MGX	PG	L	Omati
MGY	TZ	L	Mbunga
MGZ	TZ	L	Mbugwe
MHA	IN	L	Manda
MHB	GA	L	Mahongwe
MHC	MX	L	Mocho
MHD	TZ	L	Mbugu
MHE	MY	L	Besisi
MHF	PG	L	Mamaa
MHG	AU	N	Margu
MHH	PY	L	Maskoy Pidgin
MHI	UG	L	Ma'di
MHJ	ID	L	Madura
MHK	CM	L	Mungaka
MHL	PG	L	Mauwake
MHM	BF	L	Mòoré
MHN	ID	L	Mandar
MHO	ZM	L	Mashi
MHQ	US	N	Mandan
MHR	YE	L	Mehri
MHS	ID	L	Buru
MHT	VE	L	Mandahuaca
MHU	IN	L	Digaro
MHV	MM	L	Arakanese
MHW	NA	L	Mbukushu
MHX	MM	L	Maru
MHY	ID	L	Ma'anyan
MHZ	ID	L	Mor
MIA	US	E	Miami
MIB	MX	L	Mixteco, Atatláhuca
MIC	CA	L	Micmac
MID	IR	L	Mandaic
MIE	MX	L	Mixteco, Ocotepec
MIF	CM	L	Mofu-gudur
MIG	MX	L	Mixteco, San Miguel El Grande
MIH	MX	L	Mixteco, Chayuco
MII	MX	L	Mixteco, Chigmacatitlán
MIJ	CM	L	Missong
MIK	US	L	Mikasuki
MIL	MX	L	Mixteco, Peñoles
MIM	MX	L	Mixteco, Alacatlatzala
MIN	MY	L	Milikin
MIO	MX	L	Mixteco, Pinotepa Nacional
MIP	MX	L	Mixteco, Apasco Y Apoala
MIQ	NI	L	Mískito
MIR	MX	L	Mixe, Istmo
MIS	MX	L	Mixteco, Diuxi-tilantongo
MIT	MX	L	Mixteco, Puebla Sur
MIU	MX	L	Mixteco, Cacaloxtepec
MIV	TD	L	Mimi
MIW	PG	L	Akoye
MIX	MX	L	Mixteco, Mixtepec
MIY	MX	L	Mixteco, Ayutla
MIZ	MX	L	Mixteco, Coatzospan
MJA	MM	L	Mahei
MJB	ID	L	Marub
MJC	MX	L	Mixteco, San Juan Colorado
MJD	GB	E	Manx
MJE	TD	E	Muskum
MJF	CN	L	Manchu
MJG	CN	L	Tu
MJI	CN	L	Kim Mun
MJJ	PG	L	Mawak
MJK	PG	L	Matukar
MJL	IN	L	Mandeali
MJM	PG	L	Medebur
MJN	PG	L	Mebu
MJO	IN	L	Malankuravan
MJP	IN	L	Malapandaram
MJQ	IN	L	Malaryan
MJR	IN	L	Malavedan
MJS	IN	L	Malayalam
MJT	IN	L	Sauria Paharia
MJU	IN	L	Manna-dora
MJV	IN	L	Mannan
MJW	IN	L	Mikir
MJX	IN	L	Mahali
MJZ	NP	L	Majhi
MKB	IN	L	Mal Paharia
MKC	PG	L	Siliput
MKD	IN	L	Marwari
MKE	IN	L	Mawchi
MKF	NG	L	Miya
MKG	CN	L	Mak
MKH	ID	L	Masela, Central
MKI	PK	L	Dhatki
MKJ	MK	L	Macedonian
MKK	CM	L	Byep
MKL	BJ	L	Mokole
MKM	TH	L	Moklen
MKN	ID	L	Malay, Kupang
MKO	NG	L	Mingang Doso
MKP	IN	L	Maithili
MKQ	US	E	Miwok, Bay
MKR	PG	L	Malas
MKS	MX	L	Mixteco, Silacayoapan
MKT	NC	L	Vamale
MKU	GN	L	Maninka, Konyanka
MKV	VU	L	Mafea
MKW	CG	L	Munukutuba
MKX	PH	L	Manobo, Cinamiguin
MKY	ID	L	Makian, East
MKZ	TP	L	Makasae
MLA	VU	L	Malo
MLB	CM	L	Mbule
MLC	VN	L	Man Cao Lan
MLD	AF	L	Malakhel
MLE	PG	L	Manambu
MLF	LA	L	Mal
MLG	AF	N	Mogholi
MLH	PG	L	Mape
MLI	MY	L	Malay
MLJ	TD	L	Miltu
MLK	KE	L	Malakote
MLL	VU	L	Malua Bay
MLM	CN	L	Mulam
MLN	SB	L	Malango
MLO	AO	L	Mbundu, Loanda
MLP	PG	L	Bargam
MLQ	ML	L	Maninkakan, Western
MLR	CM	L	Pelasla
MLS	MT	L	Maltese
MLT	ID	L	Malimpung
MLU	SB	L	To'abaita
MLV	VU	L	Motlav
MLW	CM	L	Melokwo
MLX	VU	L	Malfaxal
MLY	PG	L	Mondropolon
MLZ	PH	L	Malaynon
MMA	NG	L	Mama
MMB	ID	L	Momina
MMC	IN	L	Memba
MMD	CN	L	Maonan
MME	VU	L	Mae
MMF	NG	L	Mundat
MMG	VU	L	Ambrym, North
MMH	BR	L	Mehináku
MMI	PG	L	Musar
MMJ	IN	L	Majhwar
MMK	IN	L	Mukha-dora
MML	CN	L	Man Met
MMM	VU	L	Maii
MMN	PH	L	Mamanwa
MMO	PG	L	Buang, Mangga
MMP	PG	L	Musan
MMQ	PG	L	Musak
MMR	CN	L	Hmong, Western Xiangxi
MMS	GT	L	Mam, Southern
MMT	PG	L	Malalamai
MMU	CM	L	Mmaala
MMV	BR	L	Miriti
MMW	VU	L	Emae
MMX	PG	L	Madak
MMY	TD	L	Migaama
MMZ	ZR	L	Mabaale
MNA	PG	L	Mbula
MNB	RU	L	Buriat, Russia
MNC	VN	L	Mnong, Central
MND	BR	N	Mondé
MNE	TD	L	Naba
MNF	AO	L	Umbundu
MNG	VN	L	Mnong, Eastern
MNH	ZR	L	Mono
MNI	GN	L	Maninka, Kankan
MNJ	AF	L	Munji
MNK	SN	L	Mandinka
MNL	VU	L	Tiale
MNM	PG	L	Mapena
MNN	VN	L	Mnong, Southern
MNO	FM	L	Mokilese
MNP	CN	L	Chinese, Min Bei
MNQ	MY	L	Minriq
MNR	IN	L	Meitei
MNS	RU	L	Mansi
MNT	AU	E	Maykulan
MNU	ID	L	Mer
MNV	SB	L	Rennell
MNW	MM	L	Mon
MNX	ID	L	Manikion
MNY	MZ	L	Manyawa
MNZ	ID	L	Moni
MOA	CI	L	Mwan
MOB	IN	L	Moinba
MOC	AR	L	Mocoví
MOD	US	E	Mobilian
MOE	CA	L	Montagnais
MOF	US	E	Mohegan-montauk-narragansett
MOG	ID	L	Mongondow
MOH	CA	L	Mohawk
MOI	NG	L	Mboi
MOJ	CG	L	Monzombo
MOK	ID	L	Morori
MOL	NI	E	Monimbo
MOM	ZR	L	Mongo-nkundu
MON	US	N	Mono
MOO	VN	L	Monom
MOP	BZ	L	Mopán Maya
MOQ	ID	L	Mor
MOR	SD	L	Moro
MOS	MX	L	Mixteco, Tlaxiaco Norte
MOT	CO	L	Motilón
MOU	TD	L	Mogum
MOV	US	L	Mohave
MOW	CG	L	Moi
MOX	PG	L	Molima
MOY	ET	L	Shakacho
MOZ	TD	L	Mukulu
MPA	TZ	L	Mpoto
MPB	AU	N	Mullukmulluk
MPC	AU	L	Mangarayi
MPD	BR	L	Machinere
MPE	ET	L	Majang
MPF	GT	L	Mam, Tajumulco
MPG	TD	L	Marba
MPH	AU	L	Maung
MPI	CM	L	Mpade
MPJ	AU	L	Martu Wangka
MPK	TD	L	Mbara
MPL	PG	L	Watut, Middle
MPM	MX	L	Mixteco, Yosondúa
MPN	PG	L	Mindiri
MPO	PG	L	Miu
MPP	PG	L	Migabac
MPQ	BR	L	Matís
MPR	SB	L	Vangunu
MPS	PG	L	Dadibi
MPT	PG	L	Mian
MPU	ID	L	Minangkabau
MPV	PG	L	Munkip
MPX	PG	L	Misima-paneati
MPY	ID	N	Mapia
MPZ	TH	L	Mpi
MQA	ID	L	Maba
MQB	CM	L	Mbuko
MQC	ID	L	Mangole
MQD	MY	L	Madang
MQE	PG	L	Matepi
MQF	ID	L	Momuna
MQG	ID	L	Malay, Kota Bangun Kutai
MQI	ID	L	Mariri
MQJ	ID	L	Mamasa
MQK	PH	L	Manobo, Rajah Kabunsuwan
MQL	BJ	L	Mbelime
MQM	IN	L	Magahi
MQN	ID	L	Moronene
MQO	ID	L	Modole
MQP	ID	L	Manipa
MQQ	MY	L	Minokok
MQR	ID	N	Mander
MQS	ID	L	Makian, West
MQT	TH	N	Mok
MQU	SD	L	Mandari
MQV	PG	L	Mosimo
MQW	PG	L	Murupi
MQX	ID	L	Mamuju
MQY	ID	L	Manggarai
MQZ	PG	L	Malasanga
MRA	TH	L	Mlabri
MRB	VU	L	Marino
MRC	US	L	Maricopa
MRD	NP	L	Magar, Western
MRE	US	L	Martha's Vineyard Sign Language
MRF	ID	L	Elseng
MRG	IN	L	Miri
MRH	IN	L	Chin, Mara
MRI	PK	L	Marwari
MRJ	RU	L	Mari, High
MRK	NC	L	Hmwaveke
MRL	FM	L	Mortlockese
MRM	VU	L	Merlav
MRN	SB	L	Cheke Holo
MRO	BD	L	Mru
MRP	VU	L	Morouas
MRQ	PF	L	Marquesan, North
MRR	IN	L	Maria
MRS	VU	N	Maragus
MRT	IN	L	Marathi
MRU	CM	L	Mono
MRV	PF	L	Mangareva
MRW	PH	L	Maranao
MRX	ID	L	Maremgi
MRY	PH	L	Mandaya, Karaga
MRZ	ID	L	Marind
MSA	SD	L	Masalit
MSB	PH	L	Masbatenyo
MSC	GN	L	Maninka, Sankaran
MSD	MX	L	Yucatec Maya Sign Language
MSE	TD	L	Musey
MSF	ID	L	Mekwei
MSG	ID	L	Moraid
MSI	MY	L	Malay, Sabah
MSJ	ZR	L	Ma
MSK	PH	L	Mansaka
MSL	ID	L	Molof
MSM	PH	L	Manobo, Agusan
MSN	VU	L	Mosina
MSO	ID	L	Mombum
MSP	BR	E	Maritsauá
MSQ	NC	L	Caac
MSR	ID	L	Makasar
MSS	ID	L	Masela, West
MST	PH	L	Mandaya, Cataelano
MSU	PG	L	Musom
MSV	CM	L	Maslam
MSW	GW	L	Mansoanka
MSX	PG	L	Moresada
MSY	PG	L	Aruamu
MSZ	PG	L	Momare
MTA	PH	L	Manobo, Cotabato
MTB	CI	L	Anyin, Morofo
MTC	PG	L	Munit
MTD	ID	L	Mualang
MTE	SB	L	Mono
MTF	PG	L	Murik
MTG	ID	L	Una
MTH	ID	L	Munggui
MTI	PG	L	Maiwa
MTJ	ID	L	Moskona
MTK	CM	L	Mbe'
MTL	NG	L	Montol
MTM	RU	E	Mator
MTN	NI	E	Matagalpa
MTO	MX	L	Mixe, Totontepec
MTP	BO	L	Wichí Lhamtés Nocten
MTQ	VN	L	Muong
MTR	IN	L	Mewari
MTS	PE	L	Yora
MTT	VU	L	Mota
MTU	MX	L	Mixteco, Tututepec
MTV	PG	L	Asaro'o
MTW	PH	L	Magahat
MTX	MX	L	Mixteco, Tidaá
MTY	PG	L	Nabi
MTZ	GT	L	Tacaneco
MUA	TD	L	Mundang
MUB	TD	L	Mubi
MUD	RU	N	Mednyj Aleut
MUE	EC	L	Media Lengua
MUF	VE	L	Mutús
MUG	CM	L	Musgu
MUH	SD	L	Mündü
MUI	ID	L	Musi
MUK	NP	L	Mugu
MUL	NG	L	Mumuye
MUM	PG	L	Maiwala
MUN	CM	L	Mundani
MUO	CM	L	Nyong
MUP	IN	L	Malvi
MUQ	CN	L	Hmong, Eastern Xiangxi
MUR	SD	L	Murle
MUS	VN	L	Mantsi
MUT	IN	L	Muria, Western
MUU	KE	N	Yaaku
MUV	IN	L	Muthuvan
MUW	IN	L	Mundari
MUX	PG	L	Mbo-ung
MUY	CM	L	Muyang
MUZ	ET	L	Mursi
MVA	PG	L	Manam
MVB	US	E	Mattole
MVC	GT	L	Mam, Central
MVD	ID	L	Mamboru
MVE	MX	L	Mixe, Quetzaltepec
MVF	CN	L	Mongolian, Peripheral
MVG	MX	L	Mixteco, Yucuañe
MVH	TD	L	Mire
MVI	JP	L	Miyako
MVJ	GT	L	Mam, Todos Santos Cuchumatán
MVK	PG	L	Mekmek
MVM	CN	L	Muya
MVN	PG	L	Minaveha
MVO	SB	L	Marovo
MVP	ID	L	Duri
MVQ	PG	L	Moere
MVR	ID	L	Marau
MVS	ID	L	Massep
MVT	VU	L	Mpotovoro
MVU	TD	L	Marfa
MVV	MY	L	Tagal Murut
MVW	TZ	L	Machinga
MVX	ID	L	Meoswar
MVY	PK	L	Kohistani, Indus
MWA	PG	L	Mwatebu
MWB	PG	L	Muniwara
MWC	PG	L	Are
MWD	AU	L	Mudbura
MWE	TZ	L	Mwera
MWF	AU	L	Murrinh-patha
MWG	PG	L	Aiklep
MWH	PG	L	Mouk-aria
MWI	VU	L	Labo
MWJ	AO	L	Maligo
MWK	ML	L	Maninkakan, Kita
MWL	PT	L	Miranda Do Douro
MWM	TD	L	Sar
MWN	ZM	L	Mwanga
MWO	VU	L	Maewo, Central
MWP	AU	L	Kala Lagaw Ya
MWQ	MM	L	Chin, Mün
MWR	BF	L	Marka
MWS	KE	L	Mwimbi-muthambi
MWT	MM	L	Moken
MWU	SD	E	Mittu
MWV	ID	L	Mentawai
MWW	CN	L	Hmong Daw
MWX	TZ	L	Mediak
MWY	TZ	L	Mosiro
MWZ	ZR	L	Moingi
MXA	MX	L	Mixteco, Oaxaca Noroeste
MXB	MX	L	Mixteco, Tezoatlán
MXC	ZW	L	Manyika
MXD	ID	L	Modang
MXE	VU	L	Mele-fila
MXF	CM	L	Malgbe
MXG	AO	L	Mbangala
MXH	ZR	L	Mvuba
MXI	ES	E	Mozarabic
MXJ	IN	L	Miju
MXK	PG	L	Monumbo
MXL	BJ	L	Maxi-gbe
MXM	PG	L	Meramera
MXN	ID	L	Moi
MXO	ZM	L	Mbowe
MXP	MX	L	Mixe, Tlahuitoltepec
MXQ	MX	L	Mixe, Juquila
MXR	MY	L	Kayan, Murik
MXS	MX	L	Mixteco, Huitepec
MXT	MX	L	Mixteco, Jamiltepec
MXU	CM	L	Mada
MXV	MX	L	Mixteco, Metlatonoc
MXW	PG	L	Mari
MXX	CI	L	Mahou
MXY	MX	L	Mixteco, Nochixtlán Sureste
MXZ	CI	L	Moru
MYA	CM	L	Mambila, Cameroon
MYB	TD	L	Mbay
MYC	ZR	L	Mayeka
MYD	PG	L	Maramba
MYE	GA	L	Myene
MYF	ET	L	Bambassi
MYG	CM	L	Manta
MYH	US	L	Makah
MYI	IN	L	Mina
MYJ	SD	L	Mangayat
MYK	ML	L	Senoufo, Mamara
MYL	ID	L	Moma
MYM	ET	L	Me'en
MYN	ID	L	Muna
MYO	ET	L	Anfillo
MYP	BR	L	Múra-pirahã
MYQ	CI	L	Maninka, Forest
MYR	PE	N	Muniche
MYS	ET	L	Mesmes
MYT	PH	L	Mandaya, Sangab
MYU	BR	L	Mundurukú
MYV	RU	L	Erzya
MYW	PG	L	Muyuw
MYX	UG	L	Masaba
MYY	CO	L	Macuna
MYZ	IR	E	Mandaic, Classical
MZA	MX	L	Mixteco, Santa María Zacatepec
MZB	DZ	L	Tumzabt
MZD	CM	L	Malimba
MZE	PG	L	Morawa
MZF	PG	L	Aiku
MZG	VA	L	Monastic Sign Language
MZH	AR	L	Wichí Lhamtés Güisnay
MZI	PG	L	Mumeng
MZJ	LR	L	Manya
MZK	NG	L	Mambila, Nigeria
MZL	MX	L	Mixe, Mazatlán
MZM	MH	L	Marshallese
MZN	IR	L	Mazanderani
MZO	BR	L	Matipuhy
MZP	BO	N	Movima
MZQ	ID	L	Mori Atas
MZR	BR	L	Marúbo
MZS	CN	L	Macanese
MZT	MY	L	Mintil
MZU	PG	L	Inapang
MZV	CF	L	Manza
MZW	GH	L	Deg
MZY	MZ	L	Mozambican Sign Language
MZZ	PG	L	Maiadom
NAA	NG	L	Nandu-tari
NAB	BR	L	Nambikuára, Southern
NAC	PG	L	Narak
NAD	AU	N	Nijadali
NAE	ID	N	Naka'ela
NAF	PG	L	Nabak
NAG	IN	L	Naga Pidgin
NAH	MX	L	Náhuatl, Guerrero
NAI	MX	L	Náhuatl, Huasteca, Este
NAJ	GN	L	Nalu
NAK	PG	L	Nakanai
NAL	PG	L	Nalik
NAM	AU	L	Nangikurrunggurr
NAN	SB	L	Nanggu
NAO	NP	L	Naapa
NAP	ID	L	Napu
NAQ	NA	L	Nama
NAR	NG	L	Iguta
NAS	PG	L	Naasioi
NAT	NG	L	Hungworo
NAU	MX	L	Náhuatl, Istmo-mecayapan
NAV	US	L	Navajo
NAW	GH	L	Nawuri
NAX	PG	L	Nakwi
NAY	AU	E	Narrinyeri
NAZ	MX	L	Náhuatl, Coatepec
NBA	AO	L	Nyemba
NBB	NG	L	Ndoe
NBC	IN	L	Naga, Chang
NBD	ZR	L	Ngbinda
NBE	IN	L	Naga, Konyak
NBF	CN	L	Naxi
NBG	IN	L	Nagarchal
NBH	NG	L	Ngamo
NBI	IN	L	Naga, Mao
NBJ	AU	L	Ngarinman
NBK	PG	L	Nake
NBL	ZR	E	Ngbee
NBM	CF	L	Ngbaka Ma'bo
NBN	ID	L	Kuri
NBO	NG	L	Nkukoli
NBP	NG	L	Nnam
NBQ	ID	L	Nggem
NBR	NG	L	Numana-nunku-gwantu-numbu
NBS	NA	L	Namibian Sign Language
NBU	IN	L	Naga, Rongmei
NBV	CM	L	Ngamambo
NBW	ZR	L	Ngbandi, Southern
NBX	AU	N	Ngura
NBY	PG	L	Ningera
NCA	PG	L	Nahu
NCB	IN	L	Nicobarese, Central
NCC	PG	L	Ponam
NCD	NP	L	Nachering
NCE	PG	L	Yale
NCF	PG	L	Notsi
NCG	CA	L	Nisga'a
NCI	MX	E	Náhuatl, Classical
NCJ	MX	L	Náhuatl, Puebla Norte
NCK	AU	L	Nakara
NCL	MX	L	Náhuatl, Michoacán
NCM	PG	L	Nambu
NCN	PG	L	Nauna
NCO	PG	L	Nagovisi
NCP	CM	L	Ndaktup
NCQ	CG	L	Nchinchege
NCR	CM	L	Ncane
NCS	NI	L	Nicaraguan Sign Language
NCT	IN	L	Naga, Chothe
NCU	GH	L	Chumburung
NCX	MX	L	Náhuatl, Puebla Central
NCZ	US	E	Natchez
NDA	CG	L	Ndasa
NDB	CM	L	Kenswei Nsei
NDC	ZW	L	Ndau
NDD	NG	L	Nde-nsele-nta
NDE	TZ	L	Ndengereko
NDF	ZW	L	Ndebele
NDG	NA	L	Ndonga
NDH	TZ	L	Ndali
NDI	CM	L	Samba Leko
NDJ	TZ	L	Ndamba
NDK	ZR	L	Ndaka
NDL	ZR	L	Ndolo
NDM	TD	L	Ndam
NDN	CG	L	Ngundi
NDO	CM	L	Bamunka
NDP	ZR	L	Ndo
NDQ	AO	L	Ndombe
NDR	NG	L	Ndoola
NDS	TZ	L	Ndonde
NDT	ZR	L	Ndunga
NDU	CM	L	Pape
NDV	SN	L	Ndut
NDW	ZR	L	Ndobo
NDX	ID	L	Nduga
NDY	CF	L	Lutos
NDZ	SD	L	Ndogo
NEA	ID	L	Ngad'a, Eastern
NEB	CI	L	Toura
NEC	ID	L	Nedebang
NED	NG	L	Nde-gbite
NEE	NC	L	Kumak
NEG	RU	L	Negidal
NEH	BT	L	Nyenkha
NEJ	PG	L	Neko
NEK	NC	L	Neku
NEL	ZA	L	Ndebele
NEM	NC	L	Nemi
NEN	NC	L	Nengone
NEP	NP	L	Nepali
NER	ID	L	Yahadian
NES	IN	L	Kinnauri, Bhoti
NET	PG	L	Nete
NEV	LA	L	Nyaheun
NEW	NP	L	Newari
NEY	CI	L	Neyo
NEZ	US	L	Nez Perce
NFA	ID	L	Ndao
NFL	SB	L	Ayiwo
NFR	GH	L	Nafaanra
NFU	CM	L	Mfumte
NGA	ZR	L	Ngbaka
NGB	ZR	L	Ngbandi, Northern
NGC	ZR	L	Ngombe
NGD	CF	L	Ngando
NGE	CM	L	Ngemba
NGF	CG	L	Ngungwoni
NGG	CF	L	Ngbaka Manza
NGH	ZA	N	N/u
NGI	NG	L	Ngizim
NGJ	CM	L	Ngie
NGK	AU	L	Ngalkbun
NGL	MZ	L	Lomwe
NGM	FM	L	Ngatik Men's Creole
NGN	CM	L	Ngwo
NGO	CM	L	Balundu-bima
NGP	TZ	L	Ngulu
NGQ	TZ	L	Ngurimi
NGR	ZR	L	Ngiri
NGS	NG	L	Gvoko
NGT	LA	L	Ngeq
NGU	TZ	L	Ngoni
NGV	CM	E	Nagumi
NGW	NG	L	Ngwaba
NGX	NG	L	Nggwahyi
NGY	CM	L	Tibea
NGZ	CG	L	Teke, Northeastern
NHA	VN	L	Nhang
NHB	CI	L	Beng
NHC	MX	E	Náhuatl, Tabasco
NHD	PY	L	Chiripá
NHE	TZ	L	Nghwele
NHF	AU	N	Nhuwala
NHG	MX	L	Náhuatl, Tetelcingo
NHH	IN	L	Nahari
NHI	MX	L	Náhuatl, Tenango
NHJ	MX	N	Náhuatl, Tlalitzlipa
NHK	MX	L	Náhuatl, Istmo-cosoleacaque
NHL	IN	L	Nihali
NHM	MX	L	Náhuatl, Morelos
NHN	MX	L	Náhuatl Central
NHO	PG	L	Takuu
NHP	MX	L	Náhuatl, Istmo-pajapan
NHQ	MX	L	Náhuatl, Huaxcaleca
NHR	BW	L	Naro
NHS	MX	L	Náhuatl, Puebla Sureste
NHT	MX	L	Náhuatl, Ometepec
NHU	CM	L	Noone
NHV	MX	L	Náhuatl, Temascaltepec
NHW	MX	L	Náhuatl, Huasteco Oeste
NHX	MX	L	Náhuatl, Ixhuatlancillo
NHY	MX	L	Náhuatl, Oaxaca Norte
NHZ	MX	L	Náhuatl, Santa María La Alta
NIA	CI	L	Nyabwa
NIB	PG	L	Nakama
NIC	ID	L	Nisa
NID	AU	E	Ngandi
NIE	TD	L	Niellim
NIF	PG	L	Nek
NIG	AU	N	Ngalakan
NIH	TZ	L	Nyiha
NII	PG	L	Nii
NIJ	ID	L	Ngaju
NIK	IN	L	Nicobarese, Southern
NIL	ID	L	Nila
NIM	TZ	L	Nilamba
NIN	NG	L	Ninzam
NIO	RU	L	Nganasan
NIP	ID	L	Nias
NIQ	NU	L	Niue
NIR	ID	L	Nimboran
NIS	PG	L	Nimi
NIT	IN	L	Kolami, Southeastern
NIU	PG	L	Mato
NIV	RU	L	Gilyak
NIW	PG	L	Nimo
NIX	ZR	L	Hema
NIY	ZR	L	Ngiti
NIZ	PG	L	Ningil
NJA	NG	L	Nzanyi
NJB	IN	L	Naga, Nocte
NJE	CM	L	Koonzime
NJH	IN	L	Naga, Lotha
NJI	AU	N	Ngarndji
NJL	SD	L	Njalgulgule
NJM	IN	L	Naga, Angami
NJN	IN	L	Naga, Liangmai
NJO	IN	L	Naga, Ao
NJR	NG	N	Njerep
NJT	SR	L	Ndyuka-trio Pidgin
NJU	AU	N	Ngadjunmaya
NKA	ZM	L	Nkoya
NKB	IN	L	Naga, Khoibu Maring
NKC	CM	L	Nkongho
NKD	IN	L	Koireng
NKE	SB	L	Duke
NKF	IN	L	Naga, Kabui
NKG	PG	L	Nekgini
NKH	IN	L	Naga, Khezha
NKI	IN	L	Naga, Khoirao
NKJ	ID	L	Nakai
NKK	VU	L	Nokuku
NKN	AO	L	Nkangala
NKO	GH	L	Nkonya
NKP	TO	E	Niuatoputapu
NKQ	NG	L	Nkwak
NKR	FM	L	Nukuoro
NKS	ID	L	Asmat, North
NKU	CI	L	Kulango, Bouna
NKW	ZR	L	Nkutu
NKX	NG	L	Nkoroo
NKY	IN	L	Naga, Khiamniungan
NKZ	NG	L	Nkari
NLA	CM	L	Ngombale
NLE	KE	L	Nyala, East
NLG	SB	L	Gela
NLI	AF	L	Grangali
NLJ	ZR	L	Nyali
NLK	ID	L	Yali, Ninia
NLM	IN	L	Naga, Meluri
NLN	MX	L	Náhuatl, Durango
NLO	ZR	L	Ngul
NLR	AU	N	Ngarla
NLU	GH	L	Nchumbulu
NLV	MX	L	Náhuatl, Orizaba
NLY	AU	L	Nyamal
NMA	IN	L	Naga, Maram
NMB	VU	L	Nambas, Big
NMC	TD	L	Ngam
NMD	GA	L	Ndumu
NME	IN	L	Naga, Mzieme
NMF	IN	L	Naga, Tangkhul
NMG	CM	L	Ngumba
NMH	IN	L	Naga, Monsang
NMI	NG	L	Nyam
NMJ	CF	L	Ngombe
NMK	VU	L	Namakura
NML	CM	L	Ndemli
NMM	NP	L	Manangba
NMN	BW	L	!Xóõ
NMO	IN	L	Naga, Moyon
NMP	AU	N	Nimanbur
NMQ	ZW	L	Nambya
NMR	CM	L	Nimbari
NMS	VU	L	Letemboi
NMT	FM	L	Namonuito
NMU	US	N	Maidu, Northeast
NMV	AU	N	Ngamini
NMW	PG	L	Nimoa
NMY	CN	L	Namuyi
NMZ	TG	L	Nawdm
NNA	AU	L	Nyangumarta
NNB	ZR	L	Nandi
NNC	TD	L	Nancere
NND	VU	L	Ambae, West
NNE	AO	L	Ngandyera
NNF	PG	L	Ngaing
NNG	IN	L	Naga, Maring
NNH	CM	L	Ngiemboon
NNI	ID	L	Nuaulu, North
NNJ	ET	L	Nyangatom
NNK	PG	L	Nankina
NNL	IN	L	Naga, Ntenyi
NNM	PG	L	Namia
NNN	TD	L	Ngete
NNO	CM	L	Ngomba
NNP	IN	L	Naga, Wancho
NNQ	TZ	L	Ngindo
NNR	AU	N	Narungga
NNS	NG	L	Ningye
NNT	US	E	Nanticoke
NNU	GH	L	Dwang
NNV	AU	N	Nugunu
NNW	BF	L	Nuni, Southern
NNX	CM	N	Ngong
NNY	AU	N	Nyangga
NNZ	CM	L	Nda'nda'
NOA	PA	L	Woun Meu
NOB	ID	L	Kwerba Mamberamo
NOC	PG	L	Nuk
NOD	TH	L	Thai, Northern
NOE	IN	L	Nimadi
NOF	PG	L	Nomane
NOG	RU	L	Nogai
NOH	PG	L	Nomu
NOK	US	E	Nooksack
NOL	LA	L	Lao
NOM	PE	E	Nocaman
NON	GB	E	Norn
NOO	CA	L	Nootka
NOP	PG	L	Numanggang
NOQ	ZR	L	Ngongo
NOR	MM	L	Norra
NOS	CN	L	Yi, Yunnan
NOT	PE	L	Nomatsiguenga
NOU	PG	L	Ewage-notu
NOY	TD	N	Noy
NOZ	ET	L	Nayi
NPA	NP	L	Nar Phu
NPH	IN	L	Naga, Phom
NPL	IT	L	Napoletano-calabrese
NPO	IN	L	Naga, Pochuri
NPS	ID	L	Nipsan
NPU	IN	L	Naga, Puimei
NQG	BJ	L	Nago
NQM	ID	L	Ndom
NRA	CG	L	Ngom
NRB	ER	L	Nara
NRE	IN	L	Naga, Rengma
NRG	VU	L	Narango
NRI	IN	L	Naga, Chokri
NRL	AU	L	Ngarluma
NRM	MY	L	Narom
NRN	NO	L	Norwegian, Nynorsk
NRR	NO	L	Norwegian, Bokmaal
NRU	NR	L	Nauruan
NRX	AU	N	Ngurmbur
NRZ	PG	L	Nara
NSA	IN	L	Naga, Sangtam
NSC	NG	L	Nshi
NSE	ZM	L	Nsenga
NSG	TZ	L	Ngasa
NSH	CM	L	Ngishe
NSI	NG	L	Nigerian Sign Language
NSK	CA	L	Naskapi
NSL	NO	L	Norwegian Sign Language
NSM	IN	L	Naga, Sumi
NSN	PG	L	Nehan
NSO	CM	L	Lamnso'
NSP	NP	L	Nepalese Sign Language
NSQ	US	N	Miwok, Northern Sierra
NSR	CA	L	Maritime Sign Language
NSS	PG	L	Nali
NST	IN	L	Naga, Tase
NSW	VU	L	Navut
NSX	AO	L	Nsongo
NSZ	US	N	Nisenan
NTE	MZ	L	Nathembo
NTI	BF	L	Natioro
NTJ	AU	L	Ngaanyatjarra
NTK	TZ	L	Ikoma
NTM	BJ	L	Nateni
NTO	ZR	L	Ntomba
NTP	MX	L	Tepehuán Norte
NTR	GH	L	Delo
NTS	CO	E	Natagaimas
NTZ	IR	L	Natanzi
NUA	NC	L	Yuaga
NUB	BT	L	Nupbikha
NUC	BR	E	Nukuini
NUD	PG	L	Ngala
NUE	ZR	L	Ngundu
NUF	CN	L	Nusu
NUG	AU	N	Nungali
NUH	NG	L	Ndunda
NUI	GQ	L	Ngumbi
NUJ	UG	L	Nyole
NUK	IN	L	Nuka-dora
NUL	ID	N	Nusa Laut
NUM	TO	L	Niuafo'ou
NUN	MM	L	Nung
NUO	VN	L	Nguôn
NUP	NG	L	Nupe-nupe-tako
NUQ	PG	L	Nukumanu
NUR	PG	L	Nuguria
NUS	SD	L	Nuer
NUT	VN	L	Nung
NUU	ZR	L	Ngbundu
NUV	BF	L	Nuni, Northern
NUX	PG	L	Mehek
NUY	AU	L	Nunggubuyu
NUZ	MX	L	Náhuatl, Tlamacazapa
NVH	VU	N	Nasarian
NWE	CM	L	Ngwe
NWI	VU	L	Tanna, Southwest
NWR	PG	L	Nawaru
NXA	TP	L	Nauete
NXD	ZR	L	Ngando
NXE	ID	L	Nage
NXG	ID	L	Ngad'a
NXJ	ID	L	Nyadu
NXL	ID	L	Nuaulu, South
NXN	AU	N	Ngawun
NXR	PG	L	Ninggerum
NXU	ID	L	Narau
NXX	ID	L	Nafri
NYA	ZR	L	Nyanga
NYB	GH	L	Nyangbo
NYC	ZR	L	Nyanga-li
NYD	KE	L	Nyore
NYE	AO	L	Nyengo
NYF	KE	L	Giryama
NYG	ZR	L	Nyindu
NYH	AU	L	Nyigina
NYI	SD	L	Ama
NYJ	MW	L	Nyanja
NYK	AO	L	Nyaneka
NYL	TH	L	Nyeu
NYM	TZ	L	Nyambo
NYN	UG	L	Nyankore
NYO	SD	L	Nyamusa-molo
NYP	UG	E	Nyang'i
NYQ	IR	L	Nayini
NYR	UG	L	Nyoro
NYS	AU	L	Nyunga
NYT	AU	N	Nyawaygi
NYU	MZ	L	Nyungwe
NYV	AU	N	Nyulnyul
NYW	TH	L	Nyaw
NYX	AU	E	Nganyaywana
NYY	TZ	L	Nyakyusa-ngonde
NYZ	TZ	L	Nyamwezi
NZA	CM	L	Mbembe, Tigon
NZB	GA	L	Njebi
NZE	GH	L	Nzema
NZK	CF	L	Nzakara
NZM	IN	L	Naga, Zeme
NZS	NZ	L	New Zealand Sign Language
NZY	TD	L	Nzakambay
OAA	RU	L	Orok
OAC	RU	L	Oroch
OBI	US	E	Obispeño
OBL	CM	L	Oblo
OBO	PH	L	Manobo, Obo
OBU	NG	L	Obulom
OCA	PE	L	Ocaina
OCU	MX	N	Matlatzinca, Atzingo
ODA	NG	L	Odut
ODK	PK	L	Od
ODU	NG	L	Odual
OFO	US	E	Ofo
OFU	NG	L	Efutop
OGB	NG	L	Ogbia
OGC	NG	L	Ogbah
OGG	NG	L	Ogbogolo
OGN	ID	L	Ogan
OGU	NG	L	Ogbronuagum
OIA	ID	L	Oirata
OJB	CA	L	Ojibwa, Northwestern
OJC	CA	L	Ojibwa, Central
OJG	CA	L	Ojibwa, Eastern
OJI	CA	L	Ojibwa, Western
OJS	CA	L	Ojibwa, Severn
OKA	CA	L	Okanagan
OKB	NG	L	Okobo
OKD	NG	L	Okodia
OKE	NG	L	Okpe
OKH	IR	L	Koresh-e Rostam
OKI	KE	L	Okiek
OKJ	IN	E	Oko-juwoi
OKL	GB	L	Old Kentish Sign Language
OKN	JP	L	Oki-no-erabu
OKP	NG	L	Okpe-idesa-akuku
OKR	NG	L	Kirike
OKS	NG	L	Oko-eni-osayen
OKU	CM	L	Oku
OLA	NP	L	Walungge
OLD	TZ	L	Mochi
OLE	BT	L	Olekha
OLM	NG	L	Oloma
OLO	RU	L	Livvi
OMA	US	L	Omaha-ponca
OMB	VU	L	Ambae, East
OME	CO	E	Omejes
OMG	PE	N	Omagua
OMI	ZR	L	Omi
OML	ZR	L	Ombo
OMO	PG	L	Utarmbung
OMT	KE	L	Omotik
OMU	PE	E	Omurano
OMW	PG	L	Omwunra-toqura
ONA	AR	N	Ona
ONB	CN	L	Lingao
ONE	CA	L	Oneida
ONG	PG	L	Olo
ONI	ID	L	Onin
ONJ	PG	L	Onjab
ONN	PG	L	Onobasulu
ONO	CA	L	Onondaga
ONS	PG	L	Ono
ONT	PG	L	Ontenu
ONU	VU	L	Unua
ONX	ID	L	Onin Based Pidgin
OOG	LA	L	Ong
OON	IN	L	önge
OOR	ZA	L	Oorlams
OPA	NG	L	Okpamheri
OPK	ID	L	Kopkaka
OPM	PG	L	Oksapmin
OPO	PG	L	Opao
OPT	MX	N	ópata
OPY	BR	E	Opayé
ORA	SB	L	Oroha
ORB	ID	L	Semang, Lowland
ORC	KE	L	Orma
ORE	PE	L	Orejón
ORH	CN	L	Oroqen
ORI	NG	L	Oring
ORK	PG	L	Orokaiva
ORM	PG	L	Bine
ORN	MY	L	Orang Kanaq
ORO	PG	L	Orokolo
ORR	NG	L	Oruma
ORS	MY	L	Orang Seletar
ORT	IN	L	Oriya, Adivasi
ORU	PK	L	Ormuri
ORW	BR	N	Oro Win
ORX	NG	L	Oro
ORY	IN	L	Oriya
ORZ	ID	L	Ormu
OSA	US	N	Osage
OSE	GE	L	Osetin
OSI	ID	L	Osing
OSO	CM	L	Oso
OSR	ID	L	Siagha-yenimu
OSS	NG	L	Ososo
OST	CM	L	Osatu
OTA	MX	L	Otomí, Ixtenco
OTD	ID	L	Dohoi
OTE	MX	L	Otomí, Mezquital
OTI	BR	E	Oti
OTL	MX	N	Otomí, Tilapa
OTM	MX	L	Otomí, Sierra Oriental
OTN	MX	L	Otomí, Tenango
OTQ	MX	L	Otomí, Northwestern
OTR	SD	L	Otoro
OTS	MX	L	Otomí, Estado De México
OTT	MX	L	Otomí, Temoaya
OTU	BR	E	Otuke
OTW	CA	L	Ottawa
OTX	MX	L	Otomí, Texcatepec
OUA	DZ	L	Tagargrent
OUB	LR	L	Glio-oubi
OUE	PG	L	Oune
OUM	PG	E	Ouma
OUN	AO	L	!O!ung
OWI	PG	L	Owiniga
OYA	GF	L	Wayampi, Oiapoque
OYB	LA	L	Oy
OYD	ET	L	Oyda
OYM	BR	L	Wayampi, Amapari
OYY	PG	L	Oya'oya
PAA	PG	L	Papapana
PAB	BR	L	Parecís
PAC	VN	L	Pacoh
PAD	BR	L	Paumarí
PAE	AN	L	Papiamentu
PAF	BR	E	Paranawát
PAG	ZR	L	Pagibete
PAH	BR	L	Tenharim
PAI	NG	L	Pai
PAJ	BR	L	Ipeka-tapuia
PAK	BR	L	Parakanã
PAL	BR	L	Palikúr
PAM	ZR	L	Pambia
PAN	NG	L	Pangseng
PAO	US	L	Paiute, Northern
PAP	US	L	O'odham
PAQ	TJ	L	Parya
PAR	US	N	Panamint
PAS	ID	L	Papasena
PAT	PG	L	Papitalai
PAU	ID	L	Bauzi
PAV	BR	L	Pakaásnovos
PAW	US	N	Pawnee
PAX	BR	E	Pankararé
PAY	HN	L	Pech
PAZ	BR	E	Pankararú
PBA	CL	L	Rapa Nui
PBB	CO	L	Páez
PBC	GY	L	Patamona
PBE	MX	L	Popoloca, Mezontla
PBF	MX	L	Popoloca, Coyotepec
PBG	VE	N	Paraujano
PBH	VE	L	Panare
PBI	CM	L	Parkwa
PBL	NG	L	Mak
PBN	NG	L	Kpasam
PBO	GW	L	Papel
PBP	GN	L	Badjara
PBR	TZ	L	Pangwa
PBS	MX	L	Pame Central
PBT	AF	L	Pashto, Southern
PBU	PK	L	Pashto, Northern
PBV	IN	L	Pnar
PBY	PG	L	Pyu
PBZ	MM	L	Palu
PCA	MX	L	Popoloca, Santa Inés Ahuatempan
PCB	KH	L	Pear
PCC	CN	L	Bouyei
PCD	FR	L	Picard
PCE	MM	L	Palaung, Pale
PCF	IN	L	Paliyan
PCG	IN	L	Paniya
PCH	IN	L	Pardhan
PCI	IN	L	Duruwa
PCJ	IN	L	Parenga
PCK	IN	L	Chin, Paite
PCL	IN	L	Pardhi
PCM	NG	L	Pidgin, Nigerian
PCN	NG	L	Piti
PCP	BO	N	Pacahuara
PCR	CN	L	Panang
PCW	NG	L	Pyapun
PDA	PG	L	Anam
PDC	US	L	German, Pennsylvania
PDG	PG	L	Tok Pisin
PDN	ID	L	Podena
PDO	ID	L	Padoe
PDU	MM	L	Karen, Padaung
PEA	ID	L	Indonesian, Peranakan
PEB	US	E	Pomo, Eastern
PEC	ID	L	Pesisir, Southern
PED	PG	L	Mala
PEE	ID	L	Taje
PEF	US	N	Pomo, Northeastern
PEG	IN	L	Pengo
PEH	CN	L	Bonan
PEI	MX	L	Chichimeca-jonaz
PEJ	US	E	Pomo, Northern
PEK	PG	L	Penchal
PEL	ID	L	Pekal
PEM	ZR	L	Phende
PEN	ID	L	Penesak
PEO	US	N	Pomo, Southeastern
PEP	PG	L	Kunja
PEQ	US	N	Pomo, Southern
PER	ZR	L	Bhele
PES	IR	L	Farsi, Western
PET	TJ	L	Tajiki
PEX	PG	L	Petats
PEY	ID	L	Petjo
PEZ	MY	L	Penan, Eastern
PFA	FM	L	Pááfang
PFL	DE	L	Pfaelzisch
PGA	SD	L	Arabic, Sudanese Creole
PGG	IN	L	Pangwali
PGI	PG	L	Pagi
PGK	VU	L	Rerep
PGU	ID	L	Pagu
PGY	NP	N	Pongyong
PHA	CN	L	Bunu, Baheng
PHD	IN	L	Phudagi
PHG	VN	L	Phuong
PHH	VN	L	Phula
PHK	IN	L	Phake
PHL	PK	L	Phalura
PHN	LA	L	Phana'
PHO	LA	L	Phunoi
PHR	PK	L	Pahari-potwari
PHT	TH	L	Phu Thai
PHU	TH	L	Phuan
PHV	AF	L	Pahlavani
PHW	NP	L	Phangduwali
PIA	MX	L	Pima Bajo, Sonora
PIB	PE	L	Yine
PIC	GA	L	Pinji
PID	VE	L	Piaroa
PIE	US	E	Piro
PIF	FM	L	Pingelapese
PIG	PE	L	Pisabo
PIH	NF	L	Pitcairn-norfolk
PII	AU	N	Pini
PIJ	CO	E	Pijao
PIK	PG	L	Bainapi
PIL	BJ	L	Pila
PIM	US	E	Powhatan
PIN	PG	L	Piame
PIO	CO	L	Piapoco
PIP	NG	L	Pero
PIQ	CN	L	Bai
PIR	BR	L	Piratapuyo
PIS	SB	L	Pijin
PIT	AU	N	Pitta Pitta
PIU	AU	L	Pintupi-luritja
PIV	SB	L	Pileni
PIW	TZ	L	Pimbwe
PIX	PG	L	Piu
PIY	NG	L	Piya-kwonci
PIZ	NC	L	Pije
PJT	AU	L	Pitjantjatjara
PKB	KE	L	Pokomo, Upper
PKG	PG	L	Pak-tong
PKH	IN	L	Pankhu
PKN	AU	N	Pakanha
PKO	KE	L	Pökoot
PKP	CK	L	Pukapuka
PKS	PK	L	Pakistan Sign Language
PKT	LA	L	Maleng
PKU	ID	L	Paku
PLA	PG	L	Miani
PLB	VU	L	Polonombauk
PLC	PH	L	Palawano, Central
PLD	GB	L	Polari
PLE	ID	L	Palu'e
PLG	AR	L	Pilagá
PLH	ID	N	Paulohi
PLI	PG	L	Apalik
PLK	PK	L	Shina, Kohistani
PLL	IN	E	Pali
PLM	ID	L	Palembang
PLN	CO	L	Palenquero
PLO	MX	L	Popoluca, Oluta
PLP	NP	L	Palpa
PLR	CI	L	Senoufo, Palaka
PLS	MX	L	Popoloca, San Marcos Tlalcoyalco
PLU	PW	L	Palauan
PLV	PH	L	Palawano, Southwest
PLW	PH	L	Palawano, Brooke's Point
PLX	ID	L	Palamul
PLY	CN	L	Palyu
PLZ	MY	L	Paluan
PMA	VU	L	Paama
PMB	MX	L	Pima Bajo, Chihuahua
PMC	ID	E	Palumata
PME	NC	L	Pwaamei
PMI	CN	L	Pumi, Northern
PML	TN	E	Lingua Franca
PMM	CG	L	Pol
PMN	CM	L	Pam
PMO	ID	L	Pom
PMP	PH	L	Pampangan
PMQ	MX	L	Pame Norte
PMR	PG	L	Paynamar
PMS	IT	L	Piemontese
PMT	PF	L	Tuamotuan
PMU	IN	L	Panjabi, Mirpur
PMW	US	N	Miwok, Plains
PMX	IN	L	Naga, Poumei
PMZ	MX	E	Pame Sur
PNA	MY	L	Punan Bah-biau
PNB	PK	L	Panjabi, Western
PNC	ID	L	Pannei
PNE	MY	L	Penan, Western
PNF	FM	L	Pohnpeian
PNG	PH	L	Pangasinan
PNH	CK	L	Penrhyn
PNI	ID	L	Aoheng
PNJ	IN	L	Panjabi, Eastern
PNL	NP	L	Panchgaunle
PNM	MY	L	Punan Batu 1
PNN	PG	L	Pinai-hagahai
PNO	PE	E	Panobo
PNP	ID	L	Pancana
PNQ	BF	L	Pana
PNR	PG	L	Panim
PNS	ID	L	Ponosakan
PNT	GR	L	Pontic
PNU	CN	L	Bunu, Jiongnai
PNV	AU	N	Pinigura
PNW	AU	L	Panytyima
PNX	LA	L	Phong-kniang
PNY	CM	L	Pinyin
PNZ	CF	L	Pana
POA	GT	L	Pokomam, Eastern
POB	GT	L	Pokomchí, Western
POC	GT	L	Pokomam, Central
POD	CO	E	Ponares
POE	MX	L	Popoloca, San Juan Atzingo
POF	ZR	L	Poke
POG	BR	E	Potiguára
POH	GT	L	Pokomchí, Eastern
POI	MX	L	Popoluca, Sierra
POJ	KE	L	Pokomo, Lower
POK	BR	L	Pokangá
POL	NG	L	Polci
POM	PG	L	Motu, Hiri
PON	NG	L	Pongu
POO	US	N	Pomo, Central
POP	NC	L	Pwapwa
POQ	MX	N	Popoluca, Texistepec
POR	PT	L	Portuguese
POS	MX	L	Popoluca, Sayula
POT	US	L	Potawatomi
POU	GT	L	Pokomam, Southern
POV	GW	L	Crioulo, Upper Guinea
POW	MX	L	Popoloca, San Felipe Otlaltepec
POX	DE	E	Polabian
POY	TZ	L	Pogolo
PPA	IN	L	Pao
PPE	PG	L	Papi
PPI	MX	L	Paipai
PPK	ID	L	Uma
PPL	SV	N	Pipil
PPM	ID	L	Papuma
PPO	PG	L	Folopa
PPP	ZR	L	Pelende
PPQ	PG	L	Pei
PPR	ID	N	Piru
PPS	MX	L	Popoloca, San Luís Temalacayuca
PPT	PG	L	Pare
PPU	TW	E	Papora
PPV	BR	L	Papavô
PQL	PL	L	Polish
PRA	GH	L	Kplang
PRB	TH	L	Lua'
PRC	AF	L	Parachi
PRD	IR	L	Parsi-dari
PRE	ST	N	Principense
PRG	PL	E	Prussian
PRH	PH	L	Porohanon
PRI	NC	L	Paicî
PRK	MM	L	Parauk
PRL	PE	L	Peruvian Sign Language
PRM	PG	L	Kibiri
PRN	AF	L	Prasuni
PRO	CO	L	Providencia Sign Language
PRP	IN	L	Parsi
PRR	BR	E	Puri
PRS	AF	L	Farsi, Eastern
PRT	TH	L	Phai
PRU	ID	L	Puragi
PRV	FR	L	Provençal
PRW	PG	L	Parawen
PRY	TH	L	Pray 3
PSA	ID	L	Awyu, Miaro
PSC	IR	L	Persian Sign Language
PSD	US	L	Plains Indian Sign Language
PSE	ID	L	Pasemah
PSG	MY	L	Penang Sign Language
PSH	AF	L	Pashayi, Southwest
PSI	PG	L	Pasi
PSL	PR	L	Puerto Rican Sign Language
PSM	BO	N	Pauserna
PSN	ID	L	Panasuan
PSO	PL	L	Polish Sign Language
PSP	PH	L	Philippine Sign Language
PSR	PT	L	Portuguese Sign Language
PSS	PG	L	Kaulong
PST	PK	L	Pashto, Central
PSW	VU	L	Port Sandwich
PTA	PY	L	Pai Tavytera
PTH	BR	E	Pataxó-hãhaãi
PTI	AU	L	Pintiini
PTN	ID	L	Patani
PTO	BR	L	Poturu
PTP	PG	L	Patep
PTR	VU	L	Piamatsina
PTT	ID	L	Enrekang
PTU	ID	L	Bambam
PTV	VU	L	Port Vato
PTW	CA	E	Pentlatch
PUA	MX	L	Purépecha, Sierra Occidental
PUB	MM	L	Purum
PUC	ID	L	Punan Merap
PUD	ID	L	Punan Aput
PUE	AR	N	Puelche
PUF	ID	L	Punan Merah
PUG	BF	L	Pwi~e~
PUI	CO	L	Puinave
PUJ	ID	L	Punan Tubu
PUK	LA	L	Pu Ko
PUM	NP	L	Puma
PUN	ID	L	Pubian
PUO	VN	L	Puoc
PUP	PG	L	Pulabu
PUQ	PE	E	Puquina
PUR	BR	L	Puruborá
PUS	CN	L	Pumi, Southern
PUT	ID	L	Putoh
PUU	GA	L	Punu
PUW	FM	L	Puluwatese
PUX	PG	L	Puari
PUY	US	E	Purisimeño
PWA	PG	L	Pawaia
PWG	PG	L	Gapapaiwa
PWM	PH	L	Molbog
PWN	TW	L	Paiwan
PWO	MM	L	Karen, Pwo Western
PWW	TH	L	Karen, Pwo Northern
PYE	CI	L	Krumen, Pye
PYM	NG	L	Fyam
PYN	BR	L	Poyanáwa
PYU	TW	L	Pyuma
PYY	MM	L	Pyen
PZH	TW	N	Pazeh
QAK	CN	L	Kuanhua
QAN	PE	L	Quechua, Ancash, Huaylas
QAR	PE	L	Quechua, Arequipa-la Union
QAS	IN	L	Kanashi
QCL	PE	E	Quechua, Classical
QCP	PE	N	Quechua, Pacaroas
QEA	PE	L	Quechua, Apurimac
QEC	PE	L	Quechua, Ancash, Chiquian
QED	PE	L	Quechua, Ancash, Conchucos, Northern
QEE	PE	L	Quechua, Ancash, Corongo
QEF	PE	L	Quechua, Pasco, Santa Ana De Tusi
QEG	PE	L	Quechua, San Rafael-huariaca
QEH	PE	L	Quechua, Ancash, Conchucos, Southern
QEI	PE	L	Quechua, Margos-yarowilca-lauricocha
QEJ	PE	L	Quechua, Huánuco, Huamalíes-northern Dos De Mayo
QEM	PE	L	Quechua, Huánuco, Panao
QEP	PE	L	Quechua, Puno
QES	PE	L	Quechua, Ancash, Sihuas
QEY	CN	L	Queyu
QHJ	PE	L	Quechua, Wanca, Jauja
QHO	EC	L	Quichua, Highland, Imbabura
QHU	PE	L	Quechua, Wanca, Huaylla
QIE	GT	L	Quiché, San Andrés
QIM	ET	L	Agaw, Western
QJU	PE	L	Quechua, North Junín
QKA	IN	L	Kurumba, Alu
QKB	IN	L	Kurumba, Betta
QKC	IN	L	Kachari
QKD	AU	N	Kuthant
QKE	PG	L	Kesawai
QKF	BR	L	Korubo
QKG	PG	L	Koguman
QKH	BR	E	Kambiwá
QKI	BR	N	Katawixi
QKJ	IN	L	Kurumba, Jennu
QKK	PG	L	Kowaki
QKL	AU	L	Kuuku-ya'u
QKM	PG	L	Kominimung
QKO	PG	L	Kopar
QKP	BR	E	Kapinawá
QKQ	BR	E	Kaimbé
QKR	PG	L	Karawa
QKS	BR	E	Guana
QKT	PK	L	Khetrani
QKU	AU	N	Kuwama
QKV	TR	L	Kirmanjki
QKW	ID	L	Kokoda
QKX	ID	L	Kauwera
QKY	AU	N	Kamu
QKZ	BR	E	Kamba
QLB	EC	L	Quichua, Pastaza, Northern
QLN	EC	L	Quichua, Lowland, Napo
QMA	SO	L	Maay
QMB	MX	L	Mixteco, Chazumba
QMC	MX	L	Mixteco, San Juan Teita
QMD	UG	L	Ma'di, Southern
QMG	MX	L	Mixteco, San Miguel Piedras
QMH	MX	N	Mixteco, Sindihui
QMI	MX	L	Mixteco, Sinicahua
QMJ	MX	L	Mixteco, Tijaltepec
QMK	IN	L	Mirgan
QML	SN	L	Mlomp
QMM	MN	L	Mongolian Sign Language
QMN	MX	L	Mazahua, Michoacán
QMO	IT	L	Mócheno
QMP	MX	L	Mixteco, Magdalena Peñasco
QMQ	SY	E	Mlahsö
QMR	CN	L	Qiang, Southern
QMS	PF	L	Marquesan, South
QMT	MX	L	Mixteco, Tacahua
QMV	AF	L	Kamviri
QMX	MX	L	Mixteco, Alcozauca
QMY	MX	L	Mixteco, Yoloxochitl
QMZ	MX	L	Mixteco, Cuyamecalco
QNB	TW	N	Kanakanabu
QNL	PE	L	Quechua, North Lima, Cajatambo
QNT	PE	L	Quechua, Cajamarca
QQC	EC	L	Quichua, Highland, Cañar
QQK	PG	L	Keuru
QQS	EC	L	Quichua, Highland, Tungurahua
QQU	EC	L	Quichua, Highland, Loja
QSA	PE	L	Quechua, San Martín
QSQ	IR	L	Qashqa'i
QUA	US	N	Quapaw
QUB	PE	L	Quechua, Huánuco, Huallaga
QUC	GT	L	Quiché, Central
QUD	EC	L	Quichua, Highland, Calderón
QUE	CL	L	Quechua, Chilean
QUF	PE	L	Quechua, Lambayeque
QUG	EC	L	Quichua, Highland, Chimborazo
QUH	BO	L	Quechua, South Bolivian
QUI	US	N	Quileute
QUJ	GT	L	Quiché, Joyabaj
QUK	PE	L	Quechua, Chachapoyas
QUL	BO	L	Quechua, North Bolivian
QUM	GT	L	Sipacapense
QUN	US	N	Quinault
QUO	AR	L	Quechua, Northwest Jujuy
QUP	PE	L	Quechua, Pastaza, Southern
QUQ	ES	L	Quinqui
QUR	PE	L	Quechua, Pasco-yanahuanca
QUS	AR	L	Quichua, Santiago Del Estero
QUT	GT	L	Quiché, West Central
QUU	GT	L	Quiché, Eastern, Chichicastenango
QUV	GT	L	Sacapulteco
QUW	EC	L	Quichua, Lowland, Tena
QUX	PE	L	Quechua, Yauyos
QUY	PE	L	Quechua, Ayacucho
QUZ	PE	L	Quechua, Cuzco
RAA	NP	L	Dungmali
RAB	NP	L	Camling
RAC	ID	L	Rasawa
RAD	VN	L	Rade
RAE	ID	L	Ranau
RAF	NP	L	Meohang, Western
RAG	KE	L	Logooli
RAH	IN	L	Rabha
RAI	PG	L	Ramoaaina
RAJ	ID	L	Rawas
RAK	PG	L	Bohuai
RAL	MM	L	Ralte
RAM	BR	L	Canela
RAN	ID	L	Riantana
RAO	PG	L	Rao
RAP	PG	L	Rapting
RAQ	NP	N	Saam
RAR	NP	L	Bahing
RAS	SD	L	Tegali
RAT	IR	L	Razajerdi
RAU	NP	L	Raute
RAV	NP	L	Sangpang
RAW	MM	L	Rawang
RAX	NG	L	Rang
RAY	PF	L	Rapa
RAZ	ID	L	Rahambuu
RBB	MM	L	Palaung, Rumai
RCF	RE	L	Réunion Creole French
RDB	IR	L	Rudbari
REA	PG	L	Rerau
REB	ID	L	Rembong
REE	MY	L	Kayan, Rejang
REG	TZ	L	Kara
REI	IN	L	Reli
REJ	ID	L	Rejang
REL	KE	L	Rendille
REM	PE	E	Remo
REN	VN	L	Rengao
RER	ET	L	Rer Bare
RES	NG	L	Reshe
RET	ID	L	Retta
REY	BO	N	Reyesano
RGA	VU	L	Roria
RGE	GR	L	Romano-greek
RGK	NP	L	Rangkas
RGR	PE	N	Resígaro
RGS	VN	L	Roglai, Southern
RHE	CH	L	Romansch
RHP	PG	L	Yahang
RIA	IN	L	Riang
RIE	LA	L	Rien
RIF	MA	L	Tarifit
RIL	MM	L	Riang
RIM	TZ	L	Nyaturu
RIN	NG	L	Nungu
RIR	ID	L	Ribun
RIT	AU	L	Ritarungo
RIU	ID	L	Riung
RJB	IN	L	Rajbangsi
RJG	ID	L	Rajong
RJI	NP	L	Raji
RKA	KH	L	Kraol
RKH	CK	L	Rakahanga-manihiki
RMA	NI	N	Rama
RMB	AU	L	Rembarunga
RMC	CZ	L	Romani, Carpathian
RMD	DK	L	Traveller Danish
RME	GB	L	Angloromani
RMF	FI	L	Romani, Kalo Finnish
RMG	NO	L	Traveller Norwegian
RMH	ID	L	Murkim
RMI	AM	L	Lomavren
RMK	PG	L	Romkun
RMM	ID	L	Roma
RMN	YU	L	Romani, Balkan
RMO	YU	L	Romani, Sinte
RMP	PG	L	Rempi
RMR	ES	L	Caló
RMS	RO	L	Romanian Sign Language
RMT	IR	L	Domari
RMU	SE	L	Tavringer Romani
RMW	GB	L	Romani, Welsh
RMY	RO	L	Romani, Vlax
RND	ZR	L	Ruund
RNN	ID	L	Roon
RNW	TZ	L	Rungwa
ROB	ID	L	Tae'
ROC	VN	L	Roglai, Cacgia
ROD	NG	L	Rogo
ROE	PG	L	Ronji
ROF	TZ	L	Rombo
ROG	VN	L	Roglai, Northern
ROH	VN	L	Romam
ROK	PG	L	Rocky Peak
ROL	PH	L	Romblomanon
ROM	PL	L	Romani, Baltic
RON	MZ	L	Ronga
ROO	PG	L	Rotokas
ROP	AU	L	Kriol
ROR	ID	L	Rongga
ROT	ID	L	Rote
ROU	TD	L	Runga
ROW	ID	L	Rote, Western
RPN	VU	L	Repanbitip
RRI	SB	L	Ririo
RRO	PG	L	Roro
RRT	CK	L	Rarotongan
RSB	YU	L	Romano-serbian
RSH	IR	L	Rashti
RSI	SB	L	Rennellese Sign Language
RSL	RU	L	Russian Sign Language
RTH	ID	L	Ratahan
RTM	FJ	L	Rotuman
RTW	IN	L	Rathawi
RUA	RW	L	Rwanda
RUB	UG	L	Gungu
RUC	UG	L	Ruli
RUD	BI	L	Rundi
RUE	UA	L	Rusyn
RUF	TZ	L	Ruguru
RUG	SB	L	Roviana
RUH	IN	N	Ruga
RUI	TZ	L	Rufiji
RUK	NG	L	Che
RUM	RO	L	Romanian
RUN	CO	E	Runa
RUO	HR	L	Romanian, Istro
RUP	GR	L	Romanian, Macedo
RUQ	GR	L	Romanian, Megleno
RUR	TZ	L	Rungi
RUS	RU	L	Russian
RUT	RU	L	Rutul
RUU	MY	L	Lobu, Lanas
RUW	BY	L	Belarusan
RUY	NG	L	Mala
RUZ	NG	L	Ruma
RWA	PG	L	Rawo
RWK	TZ	L	Rwa
RWM	UG	L	Amba
RWO	PG	L	Rawa
RYN	JP	L	Amami-oshima, Northern
RYS	JP	L	Yaeyama
RYU	JP	L	Okinawan, Central
SAA	TD	L	Saba
SAB	PA	L	Buglere
SAC	US	L	Mesquakie
SAD	ID	L	Sajau Basap
SAE	BR	L	Sabanês
SAF	GH	L	Safaliba
SAG	GA	L	Sake
SAH	ID	L	Sauri
SAI	TW	L	Saisiyat
SAJ	CF	L	Sango
SAK	RU	L	Selkup
SAL	US	E	Salinan
SAM	BR	L	Sanumá
SAN	ID	L	Sangir
SAO	ID	L	Sause
SAP	PY	L	Sanapaná
SAQ	KE	L	Samburu
SAR	BO	E	Saraveca
SAS	ID	L	Sasak
SAT	ZR	L	Sakata
SAU	ID	L	Saleman
SAV	SN	L	Saafi-saafi
SAW	ID	L	Sawi
SAX	DO	L	Samaná English
SAY	NG	L	Saya
SAZ	IN	L	Saurashtra
SBA	TD	L	Ngambay
SBB	SB	L	Simbo
SBC	PG	L	Kele
SBD	BF	L	Samo, Southern
SBE	PG	L	Saliba
SBF	ET	L	Shabo
SBG	ID	L	Seget
SBH	PG	L	Sori-harengan
SBI	PG	L	Seti
SBJ	TD	L	Surbakhal
SBK	TZ	L	Safwa
SBL	PH	L	Sambal, Botolan
SBM	TZ	L	Sagala
SBN	PK	L	Sindhi Bhil
SBO	MY	L	Sabüm
SBP	TZ	L	Sangu
SBQ	PG	L	Sileibi
SBR	TZ	L	Sandawe
SBS	NA	L	Subiya
SBT	ID	L	Kimki
SBU	IN	L	Stod Bhoti
SBV	ID	L	Suku Batin
SBW	GA	L	Simba
SBX	ID	L	Seberuang
SBY	ZM	L	Soli
SBZ	CF	L	Sara Kaba
SCA	MM	L	Sansu
SCB	VN	L	Chut
SCC	KH	L	Samre
SCE	CN	L	Dongxiang
SCG	ID	L	Sanggau
SCI	LK	L	Sri Lankan Creole Malay
SCK	IN	L	Sadri
SCL	PK	L	Shina
SCN	IT	L	Sicilian
SCO	GB	L	Scots
SCP	NP	L	Helambu Sherpa
SCQ	KH	L	Sa'och
SCR	NP	L	Sherpa
SCS	CA	L	Slavey, North
SCU	IN	L	Shumcho
SCV	NG	N	Sheni
SCW	NG	L	Sha
SCY	SE	L	Skåne
SDA	ID	L	Toraja-sa'dan
SDC	IT	L	Sardinian, Sassarese
SDE	NG	L	Surubu
SDG	AF	L	Savi
SDI	ID	L	Sindang Kelingi
SDL	SA	L	Saudi Arabian Sign Language
SDM	ID	L	Semandang
SDN	IT	L	Sardinian, Gallurese
SDO	MY	L	Bukar Sadong
SDP	IN	L	Sherdukpen
SDR	BD	L	Sadri, Oraon
SDS	TN	E	Sened
SDT	FR	E	Shuadit
SDU	ID	L	Sarudu
SDX	MY	L	Sibu
SEA	MY	L	Semai
SEB	CI	L	Senoufo, Shempire
SEC	CA	N	Sechelt
SED	VN	L	Sedang
SEE	US	L	Seneca
SEF	CI	L	Senoufo, Cebaara
SEG	TZ	L	Segeju
SEH	MZ	L	Sena
SEI	MX	L	Seri
SEJ	PG	N	Sene
SEK	CA	L	Sekani
SEL	PG	L	Selepet
SEM	ID	L	Sempan
SEN	BF	L	Sénoufo, Nanerigé
SEO	PG	L	Suarmin
SEP	BF	L	Sénoufo, Sìcìté
SEQ	BF	L	Sénoufo, Senara
SER	US	N	Serrano
SES	SN	L	Serer-sine
SET	ID	L	Sentani
SEU	ID	L	Serui-laut
SEV	CI	L	Senoufo, Nyarafolo
SEW	PG	L	Sewa Bay
SEY	EC	L	Secoya
SEZ	MM	L	Chin, Senthang
SFS	ZA	L	South African Sign Language
SFW	GH	L	Sehwi
SGA	NG	L	Sanga
SGB	PH	L	Ayta, Mag-anchi
SGE	ID	L	Segai
SGG	CH	L	Swiss-german Sign Language
SGH	TJ	L	Shughni
SGI	CM	L	Suga
SGL	TJ	L	Sanglechi-ishkashimi
SGM	UG	E	Singa
SGN	NG	L	Shamang
SGO	ZR	L	Songa
SGP	IN	L	Singpho
SGR	IR	L	Sangisari
SGT	BT	L	Brokpake
SGU	ID	L	Salas
SGZ	PG	L	Sursurunga
SHA	NG	L	Shall-zwall
SHB	BR	L	Ninam
SHC	ZR	L	Sonde
SHD	ZW	L	Shona
SHE	ET	L	Sheko
SHF	IQ	L	Shikaki
SHG	BW	L	Shua
SHH	US	L	Shoshoni
SHI	MA	L	Tachelhit
SHJ	SD	L	Shatt
SHK	SD	L	Shilluk
SHL	BD	L	Shendu
SHM	IR	L	Shahrudi
SHN	BO	E	Shinabo
SHO	NG	L	Shanga
SHP	PE	L	Shipibo-conibo
SHQ	ZM	L	Sala
SHR	ZR	L	Shi
SHS	CA	L	Shuswap
SHT	US	N	Shasta
SHU	TD	L	Arabic, Chadian Spoken
SHV	OM	L	Jibbali
SHW	SD	L	Shwai
SHX	CN	L	She
SHY	DZ	L	Chaouia
SHZ	ML	L	Senoufo, Syenara
SIA	RU	N	Saami, Akkala
SIB	MY	L	Kenyah, Sebob
SIC	PG	L	Malinguat
SID	ET	L	Sidamo
SIE	ZM	L	Simaa
SIF	BF	L	Siamou
SIG	GH	L	Sisaala, Pasaale
SIH	NC	E	Zire
SII	IN	L	Shom Peng
SIJ	PG	L	Numbami
SIK	BR	L	Sikiana
SIL	GH	L	Sisaala, Tumulung
SIM	PG	L	Mende
SIN	CO	L	Siona
SIO	PG	L	Sio
SIP	IN	L	Sikkimese
SIQ	PG	L	Sonia
SIR	NG	L	Siri
SIS	US	E	Siuslaw
SIT	PH	L	Sama, Southern
SIU	PG	L	Sinagen
SIV	PG	L	Sumariup
SIW	PG	L	Siwai
SIX	PG	L	Sumau
SIY	IR	L	Sivandi
SIZ	EG	L	Siwi
SJA	CO	L	Emberá-saija
SJL	IN	L	Sajalong
SJM	PH	L	Mapun
SJN	MM	L	Shan
SJO	CN	L	Xibe
SJP	IN	L	Surajpuri
SJR	PG	L	Lak
SJS	MA	E	Senhaja De Srair
SJW	US	L	Shawnee
SKA	US	L	Skagit
SKB	LA	L	Saek
SKC	PG	L	Sauk
SKD	US	N	Miwok, Southern Sierra
SKE	VU	L	Seke
SKF	BR	L	Sakirabiá
SKH	ID	L	Sikule
SKI	ID	L	Sika
SKK	LA	L	Sok
SKL	ID	L	Selako
SKM	PG	L	Sakam
SKN	PH	L	Subanon, Kolibugan
SKO	ID	L	Seko Tengah
SKP	MY	L	Sekapan
SKQ	BF	L	Sininkere
SKR	PK	L	Saraiki
SKS	PG	L	Maia
SKT	IN	L	Sanskrit
SKU	VU	L	Sakao
SKV	ID	L	Skou
SKW	GY	E	Skepi Creole Dutch
SKX	ID	L	Seko Padang
SKY	SB	L	Sikaiana
SKZ	ID	L	Sekar
SLA	CA	L	Slavey, South
SLB	ID	L	Saluan, Kahumamahon
SLC	CO	L	Sáliba
SLD	BF	L	Sissala
SLE	IN	L	Sholaga
SLF	CH	L	Swiss-italian Sign Language
SLG	MY	L	Selungai Murut
SLH	US	N	Salish, Southern Puget Sound
SLI	PL	L	Silesian, Lower
SLJ	BR	L	Salumá
SLK	PG	L	Sulka
SLL	PG	L	Salt-yui
SLM	PH	L	Sama, Pangutaran
SLN	RU	E	Slavonic, Old Church
SLO	SK	L	Slovak
SLP	ID	L	Lamaholot
SLQ	IR	L	Salchuq
SLR	CN	L	Salar
SLS	SG	L	Singapore Sign Language
SLT	LA	L	Sila
SLU	ID	L	Selaru
SLV	SI	L	Slovenian
SLW	PG	L	Sialum
SLX	ZR	L	Salampasu
SLY	ID	L	Selayar
SLZ	ID	L	Ma'ya
SMA	ID	L	Sembakung Murut
SMB	PG	L	Simbari
SMC	PG	L	Som
SMD	AO	L	Sama
SME	PA	N	San Miguel Creole French
SMF	PG	L	Auwe
SMG	PG	L	Simbali
SMH	CN	L	Samei
SMI	ID	L	Kambera
SMJ	IR	L	Semnani
SMK	PH	L	Bolinao
SML	PH	L	Sama, Central
SMM	NP	L	Musasa
SMN	ID	L	Semendo
SMO	PG	L	Samosa
SMP	PS	E	Samaritan
SMQ	PG	L	Samo
SMR	ID	L	Simeulue
SMS	AF	L	Shumashti
SMT	IN	L	Simte
SMU	KH	L	Somray
SMV	IN	L	Samvedi
SMW	ID	L	Sumbawa
SMX	ZR	L	Samba
SMY	WS	L	Samoan
SMZ	PG	L	Simeku
SNA	PH	L	Sambal, Tina
SNB	MY	L	Sebuyau
SNC	PG	L	Sinaugoro
SND	PK	L	Sindhi
SNE	MY	L	Jagoi
SNF	SN	L	Noon
SNG	ZR	L	Sanga
SNH	LK	L	Sinhala
SNI	PE	E	Sensi
SNJ	CF	L	Sango, Riverain
SNK	NL	L	Sallands
SNL	PH	L	Sangil
SNM	MV	L	Maldivian
SNN	ML	L	Soninke
SNO	US	N	Snohomish
SNP	PG	L	Siane
SNQ	GA	L	Sangu
SNR	PG	L	Sihan
SNS	VU	L	South West Bay
SNT	IN	L	Santali
SNU	ID	L	Senggi
SNV	ID	L	Sa'ban
SNW	GH	L	Sele
SNX	PG	L	Songum
SNY	PG	L	Saniyo-hiyewe
SNZ	PG	L	Sinsauru
SOA	TH	L	Song
SOB	ID	L	Sobei
SOC	ZR	L	So
SOD	ZR	L	Songoora
SOE	ZR	L	Songomeno
SOF	TG	L	Tamberma
SOG	UG	L	Soga
SOH	SD	L	Aka
SOI	NP	L	Sonha
SOJ	IR	L	Soi
SOK	TD	L	Sokoro
SOL	PG	L	Solos
SOM	SO	L	Somali
SON	ML	L	Songhay, Koyraboro Senni
SOO	ZR	L	Songo
SOP	ZR	L	Songe
SOQ	PG	L	Kanasi
SOR	TD	L	Somrai
SOS	BF	L	Seeku
SOT	PG	L	Silopi
SOU	TH	L	Thai, Southern
SOV	PW	L	Sonsorol
SOW	PG	L	Sowanda
SOX	CM	L	So
SOY	BJ	L	Sola
SOZ	TZ	L	Temi
SPB	ID	L	Sepa
SPC	VE	N	Sapé
SPD	PG	L	Saep
SPE	PG	L	Sepa
SPG	MY	L	Sian
SPI	ID	N	Saponi
SPJ	IL	L	Ladino
SPK	PG	L	Sengo
SPM	PG	L	Sepen
SPN	ES	L	Spanish
SPO	US	L	Spokane
SPP	ML	L	Senoufo, Supyire
SPQ	PE	L	Spanish, Loreto-ucayali
SPR	ID	L	Saparua
SPS	PG	L	Saposa
SPU	LA	L	Sapuan
SPY	KE	L	Sabaot
SQA	NG	L	Shama-sambuga
SQH	NG	N	Shau
SQM	CF	L	Suma
SQN	US	E	Susquehannock
SQO	IR	L	Sorkhei
SQQ	LA	L	Sou
SQS	LK	L	Sri Lankan Sign Language
SQT	YE	L	Soqotri
SQU	CA	N	Squamish
SRA	PS	E	Samaritan Aramaic
SRB	IN	L	Sora
SRC	YU	L	Serbo-croatian
SRD	IT	L	Sardinian, Logudorese
SRE	ID	L	Sara
SRF	PG	L	Nafi
SRG	PH	L	Sulod
SRH	CN	L	Sarikoli
SRI	CO	L	Siriano
SRJ	ID	L	Serawai
SRK	MY	L	Serudung Murut
SRL	ID	L	Isirawa
SRM	SR	L	Saramaccan
SRN	SR	L	Sranan
SRO	IT	L	Sardinian, Campidanese
SRP	PG	L	Saruga
SRQ	BO	L	Sirionó
SRR	BR	L	Sararé
SRS	CA	L	Sarsi
SRT	ZA	L	Sotho, Northern
SRU	BR	L	Suruí
SRV	PH	L	Sorsogon, Waray
SRW	ID	L	Serua
SRX	IN	L	Sirmauri
SRY	PG	L	Sera
SRZ	IR	L	Shahmirzadi
SSA	VU	L	Sa
SSB	IN	L	Shobang
SSC	NG	L	Sasaru-enwan-igwe
SSD	PG	L	Siroi
SSE	PH	L	Sama, Balangingi
SSF	TW	N	Thao
SSG	PG	L	Seimat
SSH	AE	L	Arabic, Shihhi Spoken
SSI	PK	L	Sansi
SSJ	PG	L	Sausi
SSK	IN	L	Sunam
SSL	GH	L	Sisaala, Western
SSM	MY	L	Semnam
SSN	KE	L	Sanye
SSO	LS	L	Sotho, Southern
SSP	ES	L	Spanish Sign Language
SSQ	ID	L	So'a
SSR	CH	L	Swiss-french Sign Language
SSS	LA	L	Sô
SST	PG	L	Sinasina
SSU	PG	N	Susuami
SSV	VU	L	Shark Bay
SSW	PG	L	Sissano
SSX	PG	L	Samberigi
SSY	ER	L	Saho
SSZ	PG	L	Sengseng
STA	ZM	L	Settla
STB	PH	L	Subanen, Northern
STC	SB	L	Santa Cruz
STD	IN	L	Sentinel
STE	ID	L	Liana-seti
STF	PG	L	Seta
STG	VN	L	Trieng
STH	IE	L	Shelta
STI	VN	L	Stieng, Bulo
STJ	BF	L	Samo, Matya
STK	PG	L	Arammba
STL	NL	L	Stellingwerfs
STM	PG	L	Setaman
STN	SB	L	Santa Ana
STO	CA	L	Stoney
STP	MX	L	Tepehuán Sureste
STR	CA	L	Salish, Straits
STS	BJ	L	Seto-gbe
STT	VN	L	Stieng, Budeh
STU	MM	L	Samtao
STW	FM	L	Satawalese
SUA	TZ	L	Sukuma
SUB	ZR	L	Suku
SUC	PH	L	Subanon, Western
SUD	GN	L	Susu
SUE	PG	L	Suena
SUF	ID	L	Tarpia
SUG	PG	L	Suganga
SUH	KE	L	Suba
SUI	PG	L	Suki
SUJ	TZ	L	Shubi
SUK	NG	L	Sukur
SUL	PH	L	Surigaonon
SUM	NI	L	Sumo Tawahka
SUN	TD	L	Assangori
SUO	ID	L	Sunda
SUP	IQ	L	Surchi
SUQ	ET	L	Suri
SUR	NG	L	Mwaghavul
SUS	PH	L	Subanen, Central
SUT	NI	E	Subtiaba
SUU	ID	L	Sungkai
SUV	IN	L	Sulung
SUW	TZ	L	Sumbwa
SUX	ID	L	Sahu
SUY	BR	L	Suyá
SUZ	NP	L	Sunwar
SVA	GE	L	Svan
SVB	PG	L	Ulau-suain
SVE	ID	L	Serili
SVG	VC	L	Windward Caribbean Creole English
SVK	SK	L	Slovakian Sign Language
SVR	IN	L	Savara
SVS	SB	L	Savosavo
SWA	TZ	L	Swahili
SWB	KM	L	Comorian
SWC	ZR	L	Swahili, Congo
SWD	SE	L	Swedish
SWE	MM	L	Palaung, Shwe
SWF	ZR	L	Sere
SWG	DE	L	Swabian
SWH	ID	L	Seluwasan
SWI	CN	L	Sui
SWJ	GA	L	Sira
SWK	MW	L	Sena, Malawi
SWL	SE	L	Swedish Sign Language
SWN	LY	L	Sawknah
SWP	PG	L	Suau
SWQ	CM	L	Sharwa
SWR	ID	L	Saweru
SWS	KM	L	Comorian, Shingazidja
SWT	ID	L	Sawila
SWU	ID	L	Suwawa
SWW	VU	N	Sowa
SWX	BR	L	Suruahá
SWY	TD	L	Sarua
SWZ	SZ	L	Swati
SXE	GA	L	Sighu
SXG	CN	L	Shixing
SXN	DE	L	Saxon, Low
SXR	TW	N	Saaroa
SXU	DE	L	Saxon, Upper
SXW	BJ	L	Saxwe-gbe
SYA	ID	L	Siang
SYC	TR	E	Syriac
SYI	GQ	L	Seki
SYL	BD	L	Sylhetti
SYM	BF	L	Samo, Maya
SYN	IR	L	Senaya
SYO	KH	L	Suoy
SYR	TR	L	Turoyo
SYS	SD	L	Sinyar
SYU	ID	L	Sekayu
SYW	NP	L	Kagate
SZA	MY	L	Semelai
SZB	ID	L	Ngalum
SZC	MY	L	Semaq Beri
SZD	MY	E	Seru
SZE	ET	L	Seze
SZG	ZR	L	Sengele
SZK	TZ	L	Sizaki
SZN	ID	L	Sula
SZP	ID	L	Suabo
SZR	CM	L	Saa
SZV	CM	L	Isu
SZW	ID	L	Sawai
TAA	US	L	Tanana, Lower
TAB	RU	L	Tabassaran
TAC	MX	L	Tarahumara Baja
TAD	ID	L	Tause
TAE	BR	N	Tariano
TAF	BR	L	Tapirapé
TAG	SD	L	Tagoi
TAH	CA	N	Tahltan
TAI	PY	L	Tapieté
TAJ	NP	L	Tamang, Eastern
TAK	NG	L	Tala
TAL	NG	L	Tal
TAM	GH	L	Tampulma
TAN	NG	L	Tangale
TAO	US	L	Tiwa, Northern
TAP	ZR	L	Taabwa
TAQ	ML	L	Tamasheq
TAR	MX	L	Tarahumara Central
TAS	VN	E	Tay Boi
TAT	IL	L	Judeo-tat
TAU	US	L	Tanana, Upper
TAV	CO	L	Tatuyo
TAW	PG	L	Tai
TAX	TD	L	Tamki
TAY	TW	L	Atayal
TAZ	SD	L	Tocho
TBA	BR	L	Tubarão
TBB	BR	E	Tapeba
TBC	PG	L	Takia
TBD	PG	L	Kaki Ae
TBE	SB	L	Tanimbili
TBF	PG	L	Mandara
TBG	PG	L	Tairora
TBH	AU	E	Thurawal
TBI	SD	L	Gaam
TBJ	PG	L	Tiang
TBK	PH	L	Tagbanwa, Calamian
TBL	PH	L	Tboli
TBM	ZR	L	Tagbu
TBN	CO	L	Tunebo, Barro Negro
TBO	PG	L	Tawala
TBP	ID	L	Taworta
TBQ	SD	L	Tumma
TBR	SD	L	Tumtum
TBS	PG	L	Tanguat
TBT	ZR	L	Tembo
TBU	MX	E	Tubar
TBV	PG	L	Tobo
TBW	PH	L	Tagbanwa
TBX	PG	L	Kapin
TBY	ID	L	Tabaru
TBZ	BJ	L	Ditammari
TCA	PE	L	Ticuna
TCB	US	L	Tanacross
TCC	TZ	L	Datooga
TCD	GH	L	Tafi
TCE	CA	L	Tutchone, Southern
TCG	ID	L	Tamagario
TCH	TC	L	Turks And Caicos Creole English
TCI	PG	L	Wára
TCK	TM	L	Turkmen
TCL	MM	L	Taman
TCM	ID	L	Tanahmerah
TCN	NP	L	Tichurong
TCO	MM	L	Taungyo
TCP	MM	L	Chin, Tawr
TCQ	ID	L	Kaiy
TCR	PG	L	Tirio
TCS	AU	L	Torres Strait Creole
TCT	CN	L	T'en
TCU	MX	L	Tarahumara Sureste
TCV	IN	L	Tamil
TCW	IN	L	Telugu
TCX	IN	L	Toda
TCY	IN	L	Tulu
TCZ	IN	L	Chin, Thado
TDA	NE	L	Tagdal
TDB	IN	L	Panchpargania
TDC	CO	L	Emberá-tadó
TDD	CN	L	Tai Nüa
TDF	LA	L	Talieng
TDG	NP	L	Tamang, Western
TDH	NP	L	Thulung
TDI	ID	L	Tomadino
TDJ	ID	L	Tajio
TDK	NG	L	Tambas
TDL	NG	L	Tapshin
TDN	ID	L	Tondano
TDO	NG	L	Teme
TDQ	NG	L	Tita
TDR	VN	L	Todrah
TDS	ID	L	Doutai
TDT	TP	L	Tetum Prasa
TDU	MY	L	Dusun, Tempasuk
TDV	NG	L	Toro
TDY	PH	L	Tadyawan
TEA	BR	L	Terêna
TEB	EC	E	Tetete
TEC	CG	L	Teke, Central
TED	CI	L	Krumen, Tepo
TEE	MX	L	Tepehua, Huehuetla
TEF	IN	L	Teressa
TEG	CG	L	Teke, Northern
TEH	AR	N	Tehuelche
TEI	PG	L	Torricelli
TEJ	SL	L	Themne
TEK	ZR	L	Teke, Eastern
TEL	ZR	L	Tetela
TEM	BR	L	Tembé
TEN	CO	E	Tama
TEO	UG	L	Teso
TEP	MX	E	Tepecano
TEQ	SD	L	Temein
TER	NG	L	Tera
TES	ID	L	Tengger
TET	CA	L	Atikamekw
TEU	UG	L	Soo
TEV	ID	L	Teor
TEW	US	L	Tewa
TEX	SD	L	Tennet
TEY	SD	L	Tulishi
TEZ	CG	L	Teke, Western
TFI	BJ	L	Tofin-gbe
TFN	US	N	Tanaina
TFO	ID	L	Tefaro
TFR	PA	L	Teribe
TFT	ID	L	Ternate
TGA	KE	L	Sagalla
TGB	MY	L	Tebilung
TGC	PG	L	Tigak
TGD	NG	L	Ciwogai
TGE	NP	L	Tamang, Eastern Gorkha
TGF	BT	L	Chalikha
TGG	PG	L	Tangga
TGH	TT	L	Tobagonian Creole English
TGI	PG	L	Piva
TGK	ID	L	Budong-budong
TGL	PH	L	Tagalog
TGN	ET	L	Tigrigna
TGO	PG	L	Sudest
TGP	VU	L	Tangoa
TGQ	MY	L	Tring
TGR	LA	L	Tareng
TGS	VU	L	Nume
TGT	PH	L	Tagbanwa, Central
TGU	PG	L	Tanggu
TGV	BR	E	Tingui-boto
TGW	CI	L	Senoufo, Tagwana
TGX	CA	N	Tagish
TGY	SD	E	Togoyo
THA	KE	L	Tharaka
THB	IN	L	Tehri
THC	VN	L	Tai Hang Tong
THD	AU	L	Thayore
THE	NP	L	Tharu, Chitwania
THF	NP	L	Thami
THG	NP	L	Tharu, Deokhuri
THH	MX	L	Tarahumara Norte
THI	LA	L	Tai Long
THJ	TH	L	Thai
THL	NP	L	Tharu, Dangaura
THM	TH	L	Aheu
THN	NP	L	Tharu, Mahotari
THO	VN	L	Tày
THP	CA	L	Thompson
THQ	NP	L	Tharu, Kochila
THR	NP	L	Tharu, Rana
THS	NP	L	Thakali
THT	PF	L	Tahitian
THU	SD	L	Thuri
THV	DZ	L	Tamahaq, Tahaggart
THW	NP	L	Thudam Bhote
THX	LA	L	The
THY	NG	L	Tha
THZ	NE	L	Tamajeq, Tayart
TIA	DZ	L	Tidikelt Tamazight
TIB	IR	L	Taromi, Upper
TIC	CN	L	Tibetan
TID	ID	L	Tidong
TIE	ER	L	Tigré
TIF	PG	L	Tifal
TIG	SD	L	Tingal
TIH	MY	L	Timugon Murut
TII	ZR	L	Tiene
TIJ	NP	L	Tilung
TIK	CM	L	Tikar
TIL	US	E	Tillamook
TIM	PG	L	Timbe
TIN	RU	L	Tindi
TIO	PG	L	Teop
TIP	ID	L	Trimuris
TIQ	BF	L	Tiéfo
TIR	SD	L	Tira
TIS	PH	L	Itneg, Masadiit
TIU	PH	L	Adasen
TIV	NG	L	Tiv
TIW	AU	L	Tiwi
TIX	US	L	Tiwa, Southern
TIY	PH	L	Tiruray
TIZ	CN	L	Tai Hongjin
TJG	ID	L	Tunjung
TJI	CN	L	Tujia, Northern
TJO	DZ	L	Temacine Tamazight
TJS	CN	L	Tujia, Southern
TJU	AU	E	Tjurruru
TKA	BR	E	Truká
TKB	IN	L	Buksa
TKD	TP	L	Tukudede
TKE	MZ	L	Takwane
TKF	BR	E	Tukumanféd
TKK	CN	L	Takpa
TKL	CN	L	Lipo
TKM	US	E	Takelma
TKN	JP	L	Toku-no-shima
TKO	ID	L	Tokuni
TKP	SB	L	Tikopia
TKR	AZ	L	Tsakhur
TKS	IR	L	Takestani
TKT	NP	L	Tharu, Kathoriya
TKW	SB	L	Teanu
TKZ	VN	L	Takua
TLA	MX	L	Tepehuán Suroeste
TLB	ID	L	Tobelo
TLC	MX	L	Totonaca, Yecuatla
TLD	ID	L	Talaud
TLE	KE	L	Talai
TLF	PG	L	Telefol
TLG	ID	L	Tofanma
TLH	BJ	L	Toli-gbe
TLI	US	L	Tlingit
TLJ	UG	L	Talinga-bwisi
TLK	ID	L	Taloki
TLL	MX	L	Tlapaneco, Malinaltepec
TLM	VU	L	Tolomako
TLN	ID	L	Talondo'
TLO	SD	L	Talodi
TLP	MX	L	Totonaca, Filomeno Mata-coahuitlán
TLQ	MM	L	Tai Loi
TLR	SB	L	Talise
TLS	VU	L	Tambotalo
TLT	ID	L	Teluti
TLU	ID	L	Tulehu
TLV	ID	L	Taliabu
TLW	ID	L	Wemale, South
TLX	PG	L	Khehek
TLY	AZ	L	Talysh
TLZ	ID	L	Toala'
TMA	TD	L	Tama
TMB	VU	L	Katbol
TMC	TD	L	Tumak
TMD	PG	L	Haruai
TME	BR	N	Tremembé
TMF	PY	L	Toba-maskoy
TMG	ID	E	Ternateño
TMH	MY	L	Temiar
TMI	VU	L	Tutuba
TMJ	ID	L	Samarokena
TMK	NP	L	Tamang, Northwestern
TML	ID	L	Citak, Tamnim
TMM	VN	L	Tai Man Thanh
TMN	ID	L	Taman
TMO	MY	L	Temoq
TMP	LA	L	Tai Mène
TMQ	PG	L	Tumleo
TMR	ID	L	Atoni
TMS	SD	L	Tima
TMT	VU	L	Tasmate
TMU	ID	L	Iau
TMV	ZR	L	Tembo
TMW	MY	L	Temuan
TMY	PG	L	Tami
TNA	BO	L	Tacana
TNB	CO	L	Tunebo, Western
TNC	CO	L	Tanimuca-retuarã
TND	CO	N	Tunebo, Angosturas
TNE	PH	L	Kallahan, Tinoc
TNF	AF	L	Tangshewi
TNG	TD	L	Tobanga
TNH	PG	L	Maiani
TNI	ID	N	Tandia
TNJ	MY	L	Tanjong
TNK	VU	L	Kwamera
TNL	VU	L	Lenakel
TNM	ID	L	Tabla
TNN	VU	L	Tanna, North
TNO	BO	L	Toromono
TNP	VU	L	Whitesands
TNQ	BS	E	Taino
TNR	SN	L	Budik
TNS	PG	L	Tenis
TNT	ID	L	Tontemboan
TNU	LA	L	Tay Khang
TNV	BD	L	Tangchangya
TNW	ID	L	Tonsawang
TNX	SB	E	Tanema
TNY	TZ	L	Tongwe
TNZ	TH	L	Tonga
TOA	TW	E	Taokas
TOB	AR	L	Toba
TOC	MX	L	Totonaca, Coyutla
TOD	GN	L	Toma
TOE	CO	E	Tomedes
TOF	PG	L	Gizra
TOG	MW	L	Tonga
TOH	MZ	L	Gitonga
TOI	ZM	L	Tonga
TOJ	MX	L	Tojolabal
TOK	TK	L	Tokelauan
TOL	US	N	Tolowa
TOM	ID	L	Tombulu
TON	US	E	Tonkawa
TOO	MX	L	Totonaca, Xicotepec De Juárez
TOP	MX	L	Totonaca, Papantla
TOQ	SD	L	Toposa
TOR	ZR	L	Banda, Togbo-vara
TOS	MX	L	Totonaca, Sierra
TOT	MX	L	Totonaca, Patla-chicontla
TOU	VN	L	Tho
TOV	TO	L	Tongan
TOW	US	L	Jemez
TOX	PW	L	Tobian
TOY	ID	L	Topoiyo
TOZ	CM	L	To
TPA	PG	L	Taupota
TPC	MX	L	Tlapaneco, Azoyú
TPE	BD	L	Tippera
TPG	ID	L	Kula
TPI	PG	L	Toaripi
TPK	BR	E	Tupinikin
TPN	BR	E	Tupinambá
TPO	LA	L	Tai Pao
TPP	MX	L	Tepehua, Pisa Flores
TPQ	IN	L	Tukpa
TPT	MX	L	Tepehua, Tlachichilco
TPU	KH	L	Tampuan
TPV	MP	L	Tanapag
TPX	MX	L	Tlapaneco, Acatepec
TPY	BR	L	Trumaí
TPZ	PG	L	Tinputz
TQL	VU	L	Lehali
TQQ	SO	L	Tunni
TQR	SD	E	Torona
TQT	MX	L	Totonaca, Ozumatlán
TRA	AF	N	Tirahi
TRB	PG	L	Terebu
TRC	MX	L	Trique, Copala
TRD	IN	L	Turi
TRE	ID	L	Tarangan, East
TRF	TT	L	Trinidadian Creole English
TRG	IL	L	Lishán Didán
TRH	PG	L	Turaka
TRI	SR	L	Trió
TRJ	TD	L	Toram
TRK	TR	L	Turkish
TRL	GB	L	Traveller Scottish
TRM	AF	L	Tregami
TRN	BO	L	Trinitario
TRO	IN	L	Naga, Tarao
TRP	IN	L	Kok Borok
TRQ	MX	L	Trique, San Martín Itunyoso
TRR	PE	N	Taushiro
TRS	MX	L	Trique, Chicahuaxtla
TRT	ID	L	Tunggare
TRU	FM	L	Chuukese
TRV	TW	L	Taroko
TRW	PK	L	Torwali
TRX	MY	L	Tringgus
TRY	IN	N	Turung
TRZ	BR	N	Torá
TSA	GA	L	Tsaangi
TSB	ET	L	Tsamai
TSC	MZ	L	Tshwa
TSD	GR	L	Tsakonian
TSE	TN	L	Tunisian Sign Language
TSF	NP	L	Tamang, Southwestern
TSG	PH	L	Tausug
TSH	CM	L	Tsuvan
TSI	CA	L	Tsimshian
TSJ	BT	L	Tshangla
TSK	CN	L	Tseku
TSL	VN	L	Ts'ün-lao
TSM	TR	L	Turkish Sign Language
TSN	SD	L	Kelo
TSO	ZA	L	Tsonga
TSP	BF	L	Toussian, Northern
TSQ	TH	L	Thai Sign Language
TSR	VU	L	Akei
TSS	TW	L	Taiwanese Sign Language
TST	PG	L	Tais
TSU	NP	L	Chourase
TSV	GA	L	Tsogo
TSW	BW	L	Tswana
TSX	PG	L	Tao-suamato
TSY	TW	L	Tsou
TSZ	MX	L	Purépecha
TTA	US	E	Tutelo
TTB	NG	L	Gaa
TTC	GT	L	Tectiteco
TTD	PG	L	Tauade
TTE	PG	L	Bwanabwana
TTF	CM	L	Tuotomb
TTG	BN	L	Tutong 2
TTH	LA	L	Ta'oih, Upper
TTI	ID	L	Tobati
TTJ	UG	L	Tooro
TTK	CO	E	Totoro
TTL	ZM	L	Totela
TTM	ID	L	Tetun
TTN	ID	L	Towei
TTO	LA	L	Ta'oih, Lower
TTP	ID	L	Tombelala
TTQ	NE	L	Tamajaq, Tawallammat
TTR	RU	L	Tatar
TTS	TH	L	Thai, Northeastern
TTT	AZ	L	Tat, Muslim
TTU	PG	L	Torau
TTV	PG	L	Titan
TTW	MY	L	Kenyah, Tutoh
TTX	BN	L	Tutong 1
TTY	ID	L	Sikaritai
TTZ	NP	L	Tsum
TUA	PG	L	Mandi
TUB	US	N	Tübatulabal
TUC	PG	L	Mutu
TUD	BR	E	Tuxá
TUE	CO	L	Tuyuca
TUF	CO	L	Tunebo, Central
TUG	TD	L	Tunia
TUH	PG	L	Taulil-butam
TUI	CM	L	Tupuri
TUJ	ID	L	Tugutil
TUK	US	E	Tunica
TUL	NG	L	Tula
TUM	PG	L	Tomoip
TUN	RU	L	Tuvin
TUO	BR	L	Tucano
TUP	BR	N	Tuparí
TUQ	TD	L	Tedaga
TUR	NG	L	Xedi
TUS	CA	N	Tuscarora
TUT	CA	L	Tutchone, Northern
TUU	US	N	Tututni
TUV	KE	L	Turkana
TUW	MW	L	Tumbuka
TUX	BR	E	Tuxináwa
TUY	KE	L	Tugen, North
TUZ	BF	L	Turka
TVA	SB	L	Vaghua
TVD	NG	L	Tsuvadi
TVE	ID	L	Te'un
TVK	VU	L	Ambrym, Southeast
TVL	ID	L	Nalca
TVM	ID	L	Tela-masbuar
TVN	MM	L	Tavoyan
TVO	ID	L	Tidore
TVS	KE	L	Taveta
TVW	ID	L	Sedoa
TVY	TP	E	Pidgin, Timor
TWA	US	E	Twana
TWB	PH	L	Tawbuid, Western
TWC	NG	E	Teshenawa
TWD	NL	L	Twents
TWE	ID	L	Tewa
TWG	ID	L	Tereweng
TWH	VN	L	Tai Dón
TWL	MZ	L	Tawara
TWN	CM	L	Twendi
TWO	BW	L	Tswapong
TWP	PG	L	Ere
TWQ	NE	L	Tasawaq
TWR	MX	L	Tarahumara Suroeste
TWS	GH	L	Akan
TWT	BR	E	Turiwára
TWW	PG	L	Tuwari
TWX	MZ	L	Tewe
TWY	ID	L	Tawoyan
TXA	MY	L	Tombonuwo
TXC	CA	E	Tsetsaut
TXE	ID	L	Tolitoli
TXI	BR	L	Txikão
TXM	ID	L	Tomini
TXN	ID	L	Tarangan, West
TXO	IN	L	Toto
TXS	ID	L	Tonsea
TXT	ID	L	Citak
TXU	BR	L	Kayapó
TXX	MY	L	Tatana
TYA	PG	L	Tauya
TYE	NG	L	Kyenga
TYH	VN	L	O'du
TYJ	VN	L	Tay Jo
TYP	AU	N	Thaypan
TYR	VN	L	Tai Daeng
TYT	VN	L	Tay Tac
TZA	TZ	L	Tanzanian Sign Language
TZB	MX	L	Tzeltal, Bachajón
TZC	MX	L	Tzotzil, Chamula
TZE	MX	L	Tzotzil, Ch'enalhó
TZH	MX	L	Tzeltal, Oxchuc
TZJ	GT	L	Tzutujil, Eastern
TZM	MA	L	Tamazight, Central Atlas
TZN	ID	L	Tugun
TZO	MX	L	Tzotzil, Venustiano Carranza
TZS	MX	L	Tzotzil, San Andrés Larrainzar
TZT	GT	L	Tzutujil, Western
TZU	MX	L	Tzotzil, Huixtán
TZX	PG	L	Tabriak
TZZ	MX	L	Tzotzil, Zinacantán
UAM	BR	E	Uamué
UAN	LA	L	Kuan
UAR	PG	L	Tairuma
UBA	NG	L	Ubang
UBI	TD	L	Ubi
UBM	MY	L	Kenyah, Upper Baram
UBR	PG	L	Ubir
UBY	TR	E	Ubykh
UDA	NG	L	Uda
UDE	RU	N	Udihe
UDI	AZ	L	Udi
UDJ	ID	L	Ujir
UDL	CM	L	Wuzlam
UDM	RU	L	Udmurt
UDU	ET	L	Uduk
UES	ID	L	Kioko
UFI	PG	L	Ufim
UGA	PG	L	Lele
UGB	AU	N	Kuku-ugbanh
UGE	SB	L	Ughele
UGN	UG	L	Ugandan Sign Language
UGO	TH	L	Ugong
UGY	UY	L	Uruguayan Sign Language
UHA	NG	L	Uhami
UHN	ID	L	Damal
UIG	CN	L	Uyghur
UIS	PG	L	Uisai
UIV	CM	L	Iyive
UJI	NG	L	Tanjijili
UKA	ID	L	Kaburi
UKG	PG	L	Ukuriguma
UKH	CF	L	Ukhwejo
UKL	UA	L	Ukrainian Sign Language
UKP	NG	L	Ukpe-bayobiri
UKQ	NG	L	Ukwa
UKR	UA	L	Ukrainian
UKS	BR	L	Urubú-kaapor Sign Language
UKT	RU	L	Yakut
UKU	NG	L	Ukue
UKW	NG	L	Ukwuani-aboh-ndoni
ULA	NG	L	Fungwa
ULB	NG	L	Ulukwumi
ULC	RU	L	Ulch
ULF	ID	L	Usku
ULI	FM	L	Ulithian
ULK	AU	L	Meriam
ULL	IN	L	Ullatan
ULM	ID	L	Ulumanda'
ULN	PG	N	Unserdeutsch
UMA	US	L	Umatilla
UMB	PG	L	Umbu-ungu
UMD	AU	N	Umbindhamu
UMG	AU	N	Umbuygamu
UMI	MY	L	Ukit
UMM	NG	L	Umon
UMO	BR	E	Umotína
UMP	AU	L	Umpila
UMR	AU	N	Umbugarla
UMS	ID	L	Pendau
UMU	CA	N	Munsee
UNA	PG	L	Watut, North
UNE	NG	L	Uneme
UNG	AU	L	Ngarinyin
UNK	BR	L	Salumã
UNP	AU	L	Worora
UPI	PG	L	Umeda
UPV	VU	L	Uripiv-wala-rano-atchin
URA	PE	L	Urarina
URB	BR	L	Urubú-kaapor
URC	AU	N	Urningangg
URD	PK	L	Urdu
URE	BO	N	Uru
URF	AU	N	Uradhi
URG	PG	L	Urigina
URH	NG	L	Urhobo
URI	PG	L	Urim
URK	TH	L	Urak Lawoi'
URL	IN	L	Urali
URM	PG	L	Urapmin
URN	ID	L	Uruangnirin
URO	PG	L	Ura
URP	BR	L	Uru-pa-in
URR	VU	L	Lehalurup
URT	PG	L	Urat
URV	PG	E	Uruava
URW	PG	L	Usino
URX	PG	L	Urimo
URY	ID	L	Orya
URZ	BR	L	Uru-eu-uau-uau
USA	PG	L	Usarufa
USH	PK	L	Ushojo
USI	BD	L	Usui
USK	CM	L	Usaghade
USP	GT	L	Uspanteco
USU	PG	L	Uya
UTA	NG	L	Otank
UTE	US	L	Ute-southern Paiute
UTP	SB	L	Amba
UTR	NG	L	Etulo
UTU	PG	L	Utu
UUM	GE	L	Urum
UUR	VU	N	Ura
UUU	CN	L	U
UVE	NC	L	Uvean, West
UVH	PG	L	Uri
UVL	PG	L	Lote
UWA	AU	L	Kuku-uwanh
UYA	NG	L	Doko-uyanga
UZB	UZ	L	Uzbek, Northern
UZS	AF	L	Uzbek, Southern
VAA	IN	L	Vaagri Booli
VAE	CF	L	Vale
VAF	IR	L	Vafsi
VAG	GH	L	Vagla
VAH	IN	L	Varhadi-nagpuri
VAI	LR	L	Vai
VAJ	NA	L	Vasekela Bushman
VAL	PG	L	Vehes
VAM	PG	L	Vanimo
VAN	PG	L	Valman
VAO	VU	L	Vao
VAP	IN	L	Vaiphei
VAR	MX	L	Huarijío
VAS	IN	L	Vasavi
VAU	ZR	L	Vanuma
VAV	IN	L	Varli
VAY	NP	L	Wayu
VBB	ID	L	Babar, Southeast
VEC	IT	L	Venetian
VED	LK	L	Veddah
VEE	NL	L	Veluws, East
VEK	NL	L	Veenkoloniaals
VEL	NL	L	Veluws, North
VEM	NG	L	Vemgo-mabas
VEN	ZA	L	Venda
VEO	US	E	Ventureño
VEP	RU	L	Veps
VER	NG	L	Mom Jango
VGR	PK	L	Vaghri
VIB	VI	L	Virgin Islands Creole English
VID	TZ	L	Vidunda
VIE	VN	L	Vietnamese
VIF	CG	L	Vili
VIG	BF	L	Viemo
VIL	AR	N	Vilela
VIN	TZ	L	Vinza
VIS	IN	L	Vishavan
VIT	NG	L	Viti
VIV	PG	L	Iduna
VKA	AU	E	Kariyarra
VKI	NG	L	Koro Ija
VKJ	TD	L	Kujarge
VKK	ID	L	Kaur
VKL	ID	L	Kulisusu
VKM	BR	E	Kamakan
VKO	ID	L	Kodeoha
VKP	IN	L	Korlai Creole Portuguese
VKT	ID	L	Malay, Tenggarong Kutai
VKU	AU	L	Kurrama
VKY	ID	L	Kayu Agung
VKZ	NG	L	Koro Zuba
VLA	BE	L	Vlaams
VLP	VU	L	Valpei
VLR	VU	L	Vatrata
VMA	AU	N	Martuyhunira
VMB	AU	N	Mbara
VMC	MX	L	Mixteco, Juxtlahuaca
VMD	IN	L	Koraga, Mudu
VME	ID	L	Masela, East
VMF	DE	L	Mainfränkisch
VMG	PG	L	Minigir
VMH	IR	L	Maraghei
VMI	AU	N	Miwa
VMJ	MX	L	Mixteco, Ixtayutla
VMK	MZ	L	Makhuwa-shirima
VML	AU	E	Malgana
VMM	MX	L	Mixteco, Mitlatongo
VMO	ID	L	Muko-muko
VMP	MX	L	Mazateco, Soyaltepec
VMQ	MX	L	Mixteco, Soyaltepec
VMR	MZ	L	Marenje
VMS	ID	E	Moksela
VMU	AU	N	Muluridyi
VMV	US	E	Maidu, Valley
VMW	MZ	L	Makhuwa
VMX	MX	L	Mixteco, Tamazola
VMY	MX	L	Mazateco, Ayautla
VMZ	MX	L	Mazateco, Mazatlán
VNK	SB	E	Vano
VNM	VU	L	Vinmavis
VNP	VU	L	Vunapu
VOD	RU	N	Vod
VOR	NG	L	Voro
VRS	SB	L	Varisi
VRT	VU	L	Burmbar
VSL	VE	L	Venezuelan Sign Language
VUM	GA	L	Vumbu
VUN	TZ	L	Vunjo
VUT	CM	L	Vute
WAA	US	L	Walla Walla
WAB	PG	L	Wab
WAC	US	N	Wasco-wishram
WAD	ID	L	Wandamen
WAE	CH	L	Walser
WAF	BR	E	Wakoná
WAG	PG	L	Wa'ema
WAH	ID	L	Watubela
WAI	ID	L	Wares
WAJ	PG	L	Waffa
WAK	PG	L	Wahgi
WAL	WF	L	Wallisian
WAM	US	E	Wampanoag
WAN	CI	L	Wan
WAO	US	N	Wappo
WAP	GY	L	Aruma
WAQ	AU	L	Wageman
WAR	US	L	Tenino
WAS	US	N	Washo
WAT	PG	L	Wataluma
WAU	BR	L	Waurá
WAV	NG	L	Waka
WAW	BR	L	Waiwai
WAX	PG	L	Watam
WAY	SR	L	Wayana
WAZ	PG	L	Wampur
WBA	VE	L	Warao
WBB	ID	L	Wabo
WBC	ET	L	Wolaytta
WBD	PG	L	Wamsak
WBE	ID	L	Waritai
WBF	BF	L	Wara
WBH	TZ	L	Wanda
WBI	TZ	L	Wanji
WBJ	TZ	L	Wasi
WBK	AF	L	Waigali
WBL	PK	L	Wakhi
WBM	MM	L	Vo
WBP	AU	L	Warlpiri
WBQ	IN	L	Waddar
WBR	IN	L	Wagdi
WBT	AU	L	Wanman
WBV	AU	L	Wajarri
WBW	ID	L	Woi
WCA	BR	L	Yanomámi
WCI	TG	L	Waci-gbe
WDD	GA	L	Wandji
WDG	PG	L	Wadaginam
WDJ	AU	N	Wadjiginy
WDU	AU	N	Wadjigu
WEA	MM	L	Wewaw
WEC	CI	L	Wè Western
WED	PG	L	Wedau
WEE	DE	L	Sorbian, Lower
WEH	CM	L	Weh
WEI	PG	L	Were
WEL	MM	L	Welaung
WEM	BJ	L	Weme-gbe
WEN	DE	L	Sorbian, Upper
WEO	ID	L	Wemale, North
WEP	DE	L	Westphalien
WER	PG	L	Weri
WES	CM	L	Pidgin, Cameroon
WET	ID	L	Perai
WEV	NL	L	Westerwolds
WEW	ID	L	Wejewa
WFG	ID	L	Yafi
WGA	AU	N	Wagaya
WGG	AU	N	Wangganguru
WGO	ID	L	Waigeo
WGW	PG	L	Wagawaga
WGY	AU	N	Warrgamay
WHA	ID	L	Manusela
WHG	PG	L	Wahgi, North
WHK	ID	L	Kenyah, Wahau
WHU	ID	L	Kayan, Wahau
WIB	BF	L	Toussian, Southern
WIC	US	N	Wichita
WIE	AU	N	Wik-epa
WIF	AU	N	Wik-keyangan
WIG	AU	L	Wik-ngathana
WIH	AU	N	Wik-me'anha
WII	PG	L	Wiaki
WIJ	AU	L	Wik-iiyanh
WIK	AU	L	Wikalkan
WIL	AU	N	Wilawila
WIM	AU	L	Wik-mungkan
WIN	US	L	Hocák
WIR	BR	E	Wiraféd
WIT	US	N	Wintu
WIU	PG	L	Wiru
WIV	PG	L	Muduapa
WIW	AU	N	Wirangu
WIY	US	E	Wiyot
WJA	NG	L	Waja
WJI	NG	L	Warji
WKA	TZ	E	Kw'adza
WKD	ID	L	Wakde
WKW	AU	N	Wakawaka
WLA	PG	L	Walio
WLG	AU	L	Kunbarlang
WLI	ID	L	Waioli
WLK	US	E	Wailaki
WLL	SD	L	Wali
WLN	PG	L	Wanambre
WLO	ID	L	Wolio
WLR	VU	L	Wailapa
WLS	GB	L	Welsh
WLU	AU	E	Wuliwuli
WLW	ID	L	Walak
WLX	GH	L	Wali
WLY	NP	L	Waling
WMA	NG	E	Mawa
WMB	AU	N	Wambaya
WMC	PG	L	Wamas
WMH	TP	L	Waima'a
WMI	AU	N	Wamin
WMM	ID	L	Maiwa
WMN	NC	E	Waamwang
WMO	PG	L	Wom
WMS	ID	L	Wambon
WMT	AU	L	Walmajarri
WMW	MZ	L	Mwani
WNC	PG	L	Wantoat
WND	AU	E	Wandarang
WNE	PK	L	Waneci
WNK	ID	L	Wanukaka
WNM	AU	N	Wanggamala
WNO	ID	L	Wano
WNP	PG	L	Wanap
WNU	PG	L	Usan
WOA	AU	N	Tyaraity
WOB	CI	L	Wè Northern
WOC	PG	L	Wogeo
WOD	ID	L	Wolani
WOE	FM	L	Woleaian
WOF	GM	L	Wolof, Gambian
WOG	PG	L	Wogamusin
WOI	ID	L	Kamang
WOK	CM	L	Longto
WOL	SN	L	Wolof
WOM	NG	L	Wom
WON	ZR	L	Wongo
WOO	ID	L	Manombai
WOR	ID	N	Woria
WOS	PG	L	Hanga Hundi
WOW	ID	L	Wawonii
WOY	ET	E	Weyto
WRA	PG	L	Warapu
WRB	AU	N	Warluwara
WRD	AF	L	Warduji
WRE	TZ	L	Ware
WRG	AU	N	Warungu
WRH	AU	N	Wiradhuri
WRI	AU	E	Wariyangga
WRL	AU	L	Warlmanpa
WRM	AU	L	Warumungu
WRN	SD	L	Warnang
WRP	ID	L	Waropen
WRR	AU	L	Wardaman
WRS	PG	L	Waris
WRU	ID	L	Waru
WRV	PG	L	Waruna
WRW	AU	E	Gugu Warra
WRX	ID	L	Wae Rana
WRY	PH	L	Waray-waray
WRZ	AU	N	Waray
WSA	ID	L	Warembori
WSI	VU	L	Wusi
WSK	PG	L	Waskia
WSM	PG	L	Wasambu
WSR	PG	L	Owenia
WSS	GH	L	Wasa
WSU	BR	E	Wasu
WSV	AF	L	Wotapuri-katarqalai
WTF	PG	L	Dumpu
WTI	ET	L	Berta
WTK	PG	L	Watakataui
WTW	ID	L	Wotu
WUA	AU	N	Wikngenchera
WUB	AU	L	Wunambal
WUD	TG	L	Wudu
WUH	CN	L	Wutunhua
WUL	ID	L	Silimo
WUM	CG	L	Wumbvu
WUN	TZ	L	Bungu
WUT	PG	L	Wutung
WUU	CN	L	Chinese, Wu
WUV	PG	L	Wuvulu-aua
WUX	AU	N	Wulna
WWA	BJ	L	Waama
WWO	VU	L	Wetamut
WWW	CM	L	Wawa
WXA	CN	L	Waxianghua
WYA	US	E	Wyandot
WYB	AU	N	Wangaaybuwan-ngiyambaa
WYR	BR	L	Wayoró
WYY	FJ	L	Fijian, Western
XAH	ID	L	Kahayan
XAM	ZA	E	/Xam
XAN	ET	L	Xamtanga
XAO	VN	L	Khao
XAR	PG	E	Karami
XAS	RU	E	Kamas
XAV	BR	L	Xavánte
XAY	ID	L	Kayan Mahakam
XDY	ID	L	Malayic Dayak
XEG	ZA	E	//Xegwi
XEM	ID	L	Kembayan
XER	BR	L	Xerénte
XET	BR	N	Xetá
XHU	VN	L	Khua
XIA	CN	L	Xiandaohua
XII	ZA	N	Xiri
XIN	GT	E	Xinca
XIP	BR	L	Xipináwa
XIR	BR	L	Xiriâna
XKA	PK	L	Kalkoti
XKB	TG	L	Kambolé
XKC	IR	L	Khoini
XKD	ID	L	Kayan, Mendalam
XKE	ID	L	Kereho-uheng
XKF	BT	L	Khengkha
XKG	ML	L	Kagoro
XKH	BR	N	Karahawyana
XKI	KE	L	Kenyan Sign Language
XKJ	IR	L	Kajali
XKK	KH	L	Kaco'
XKL	ID	L	Kenyah, Kelinyau
XKM	ID	L	Kenyah, Mahakam
XKN	ID	L	Kayan, Kayan River
XKO	LA	L	Kiorr
XKP	IR	L	Kabatei
XKQ	ID	L	Koroni
XKR	BR	E	Xakriabá
XKS	ID	L	Kumbewaha
XKT	GH	L	Kantosi
XKV	BW	L	Kgalagadi
XKW	ID	N	Kembra
XKX	PG	L	Karore
XKY	MY	L	Kenyah, Western
XKZ	BT	L	Kurtokha
XMA	SO	L	Mushungulu
XMB	CM	L	Mbonga
XMC	MZ	L	Makhuwa-marrevone
XMD	CM	L	Mbedam
XME	BR	L	Mekem
XMF	GE	L	Mingrelian
XMG	CM	L	Mengaka
XMH	AU	L	Kuku-muminh
XMI	BR	L	Miarrã
XMJ	CM	L	Majera
XML	MY	L	Malaysian Sign Language
XMM	ID	L	Malay, Menadonese
XMN	CM	L	Mungong
XMO	BR	L	Morerebi
XMP	AU	N	Kuku-mu'inh
XMQ	AU	N	Kuku-mangk
XMS	MA	L	Moroccan Sign Language
XMT	ID	L	Matbat
XMU	MG	L	Malagasy, Southern
XMV	MG	L	Malagasy, Antankarana
XMW	MG	L	Malagasy, Tsimehety
XMX	ID	L	Maden
XMY	AU	N	Mayaguduna
XMZ	ID	L	Mori Bawah
XOK	BR	L	Xokleng
XOO	BR	E	Kirirí-xokó
XOS	ZA	L	Xhosa
XRA	BR	L	Krahô
XRE	BR	N	Kreye
XRI	BR	L	Krikati-timbira
XUF	ET	L	Kunfal
XUG	JP	L	Kunigami
XUU	NA	L	Kxoe
XWD	BJ	L	Xweda-gbe
XWE	BJ	L	Xwela-gbe
XWL	BJ	L	Xwla-gbe
XXK	ID	L	Ke'o
YAA	PE	L	Yaminahua
YAB	BR	L	Yuhup
YAC	ID	L	Yali, Pass Valley
YAD	PE	L	Yagua
YAE	VE	L	Yaruro
YAF	ZR	L	Yaka
YAG	CL	N	Yámana
YAH	TJ	L	Yazgulyam
YAI	TJ	L	Yagnobi
YAJ	CF	L	Banda-yangere
YAK	US	L	Yakima
YAL	GN	L	Yalunka
YAM	CM	L	Yamba
YAO	MW	L	Yao
YAQ	MX	L	Yaqui
YAR	VE	N	Yabarana
YAS	CM	L	Nugunu
YAT	CM	L	Yambeta
YAU	VE	L	Yuwana
YAV	CM	L	Yangben
YAW	BR	L	Yawalapití
YAX	AO	L	Yauma
YAY	NG	L	Agwagwune
YAZ	NG	L	Lokaa
YBA	NG	L	Yala
YBD	MM	L	Yangbye
YBE	CN	L	Yugur, West
YBH	NP	L	Yakha
YBI	NP	L	Yamphu
YBJ	NG	L	Hasha
YBL	NG	L	Yukuben
YBM	PG	L	Yaben
YBN	BR	E	Yabaâna
YBO	PG	L	Yabong
YBX	PG	L	Yawiyo
YBY	PG	L	Yaweyuha
YCN	CO	L	Yucuna
YDD	IL	L	Yiddish, Eastern
YDG	PK	L	Yidgha
YDK	PG	L	Yoidik
YDS	IL	L	Yiddish Sign Language
YEA	IN	L	Ravula
YEC	DE	L	Yeniche
YEE	PG	L	Yimas
YEI	CM	E	Yeni
YEJ	IL	N	Yevanic
YEL	ZR	L	Yela
YEN	NG	L	Yendang
YER	NG	L	Tarok
YES	NG	L	Yeskwa
YET	ID	L	Yetfa
YEU	IN	L	Yerukula
YEV	PG	L	Yapunda
YEY	BW	L	Yeyi
YGM	PG	L	Yagomi
YGR	PG	L	Yagaria
YGW	PG	L	Yagwoia
YHD	IL	L	Arabic, Judeo-iraqi
YIA	AU	N	Yinggarda
YIB	US	L	Yinglish
YIC	CN	L	Yi, Central
YID	ET	L	Kwegu
YIE	CN	L	Yi, Southeastern
YIG	CN	L	Yi, Guizhou
YIH	DE	N	Yiddish, Western
YII	AU	N	Yidiny
YIJ	AU	L	Yindjibarndi
YIL	AU	N	Yindjilandji
YIM	IN	L	Naga, Yimchungru
YIN	MM	L	Yinchia
YIR	ID	L	Jair
YIS	PG	L	Yis
YIW	CN	L	Yi, Western
YIY	AU	N	Yir Yoront
YKA	PH	L	Yakan
YKG	RU	L	Yukaghir, Northern
YKI	ID	L	Yoke
YKK	PG	L	Yakaikeke
YKM	PG	L	Yakamul
YKO	CM	L	Yasa
YKR	PG	L	Yekora
YKY	CF	L	Yakoma
YLA	PG	L	Yaul
YLE	PG	L	Yele
YLG	PG	L	Yelogu
YLI	ID	L	Yali, Angguruk
YLL	PG	L	Yil
YLR	AU	E	Yalarnnga
YLU	PG	L	Aribwaung
YLY	NC	L	Nyâlayu
YMA	NP	L	Yamphe
YMB	PG	L	Yambes
YME	PE	E	Yameo
YMG	ZR	L	Yamongeri
YMI	TW	L	Yami
YMK	MZ	L	Makwe
YML	PG	L	Iamalele
YMN	ID	L	Yamna
YMP	PG	L	Yamap
YND	AU	N	Yandruwandha
YNG	ZR	L	Yango
YNH	GA	L	Yangho
YNK	RU	L	Yupik, Naukan
YNL	PG	L	Yangulam
YNN	US	E	Yana
YNO	TH	L	Yong
YNS	ZR	L	Yansi
YNU	CO	E	Yahuna
YOB	PG	E	Yoba
YOG	PH	L	Yogad
YOI	JP	L	Yonaguni
YOK	US	N	Yokuts
YOM	ZR	L	Yombe
YON	PG	L	Yongkom
YOR	NG	L	Yoruba
YOS	MM	L	Yos
YOX	JP	L	Yoron
YOY	TH	L	Yoy
YPS	FM	L	Yapese
YRA	PG	L	Yerakai
YRB	PG	L	Yareba
YRE	CI	L	Yaouré
YRI	CO	L	Yarí
YRK	RU	L	Nenets
YRL	BR	L	Nhengatu
YRM	BR	L	Yarumá
YRN	CN	L	Yerong
YRS	ID	L	Yarsun
YRW	PG	L	Yarawata
YSL	YU	L	Yugoslavian Sign Language
YSR	RU	N	Yupik, Sirenik
YSS	PG	L	Yessan-mayo
YUA	MX	L	Maya, Yucatán
YUB	AU	E	Yugambal
YUC	US	N	Yuchi
YUD	IL	L	Arabic, Judeo-tripolitanian
YUE	BO	L	Yuracare
YUF	US	L	Havasupai-walapai-yavapai
YUH	CN	L	Chinese, Yue
YUI	CO	L	Yuruti
YUJ	PG	L	Karkar-yuri
YUK	US	N	Yuki
YUL	CF	L	Yulu
YUM	US	L	Quechan
YUN	NG	L	Bena
YUO	PG	L	Yubanakor
YUP	CO	L	Yukpa
YUQ	BO	L	Yuqui
YUR	US	N	Yurok
YUS	MX	L	Maya, Chan Santa Cruz
YUT	PG	L	Yopno
YUU	RU	N	Yugh
YUW	PG	L	Yau
YUX	RU	L	Yukaghir, Southern
YUY	CN	L	Yugur, East
YVA	ID	L	Yawa
YVT	VE	E	Yavitero
YWA	PG	L	Kalou
YWN	BR	L	Yawanawa
YWR	AU	E	Yawuru
YWW	AU	N	Yawarawarga
YYU	PG	L	Yau
ZAA	MX	L	Zapoteco, Juárez, Sierra
ZAB	MX	L	Zapoteco, San Juan Guelavía
ZAC	MX	L	Zapoteco, Ocotlán Oeste
ZAD	MX	L	Zapoteco, Cajonos
ZAE	MX	L	Zapoteco, Yareni
ZAF	MX	L	Zapoteco, Ayoquesco
ZAG	SD	L	Zaghawa
ZAH	NG	L	Zangwal
ZAI	MX	L	Zapoteco, Istmo
ZAJ	TZ	L	Zalamo
ZAK	TZ	L	Zanaki
ZAL	CN	L	Zauzou
ZAM	MX	L	Zapoteco, Miahuatlán Central
ZAN	ZR	L	Zande
ZAO	MX	L	Zapoteco, Ozolotepec
ZAP	MX	L	Zapoteco, Coatecas Altas
ZAQ	MX	L	Zapoteco, Aloápam
ZAR	MX	L	Zapoteco, Rincón
ZAS	MX	L	Zapoteco, Albarradas
ZAT	MX	L	Zapoteco, Tabaa
ZAU	IN	L	Zangskari
ZAV	MX	L	Zapoteco, Yatzachi
ZAW	MX	L	Zapoteco, Mitla
ZAX	MX	L	Zapoteco, Xadani
ZAY	ET	L	Zayse-zergulla
ZAZ	NG	L	Zari
ZEG	PG	L	Zenag
ZEN	MR	L	Zenaga
ZHA	CN	L	Zhaba
ZHI	NG	L	Zhire
ZIA	PG	L	Zia
ZIB	ZW	L	Zimbabwe Sign Language
ZIK	PG	L	Zimakani
ZIM	TD	L	Mesme
ZIR	NG	N	Ziriya
ZIW	TZ	L	Zigula
ZIZ	CM	L	Zizilivakan
ZKA	ID	L	Kaimbulawa
ZKM	NP	L	Kham, Maikoti
ZKR	IN	L	Zakhring
ZKS	BR	L	Kaingáng, São Paulo
ZMA	AU	N	Manda
ZMB	ZR	L	Zimba
ZMC	AU	N	Margany
ZMD	AU	N	Maridan
ZME	AU	N	Mangerr
ZMF	ZR	L	Mfinu
ZMG	AU	N	Magadige
ZMH	PG	N	Makolkol
ZMI	MY	L	Negeri Sembilan Malay
ZMJ	AU	L	Maridjabin
ZMK	AU	N	Mandandanyi
ZML	AU	N	Madngele
ZMM	AU	N	Marimanindji
ZMN	CG	L	Mbangwe
ZMO	SD	L	Molo
ZMP	ZR	L	Mpuono
ZMQ	ZR	L	Mituku
ZMR	AU	N	Maranunggu
ZMS	ZR	L	Mbesa
ZMT	AU	L	Maringarr
ZMU	AU	N	Muruwari
ZMV	AU	N	Mbariman-gudhinma
ZMW	ZR	L	Mbo
ZMX	CG	L	Bomitaba
ZMY	AU	N	Mariyedi
ZMZ	ZR	L	Mbandja
ZNA	TD	L	Zan Gula
ZOC	MX	L	Zoque, Copainalá
ZOH	MX	L	Zoque, Chimalapa
ZOM	MM	L	Zome
ZOO	MX	N	Zapoteco, Asunción Mixtepec
ZOQ	MX	N	Zoque, Tabasco
ZOR	MX	L	Zoque, Rayón
ZOS	MX	L	Zoque, Francisco León
ZPA	MX	L	Zapoteco, Lachiguiri
ZPB	MX	L	Zapoteco, Yautepec
ZPC	MX	L	Zapoteco, Choapan
ZPD	MX	L	Zapoteco, Ixtlán Sureste
ZPE	MX	L	Zapoteco, Petapa
ZPF	MX	L	Zapoteco, San Pedro Quiatoni
ZPG	MX	L	Zapoteco, Guevea De Humboldt
ZPH	MX	N	Zapoteco, Totomachapan
ZPI	MX	L	Zapoteco, Santa María Quiegolani
ZPJ	MX	L	Zapoteco, Quiavicuzas
ZPK	MX	N	Zapoteco, Tlacolulita
ZPL	MX	L	Zapoteco, Sola De Vega Este
ZPM	MX	L	Zapoteco, Mixtepec
ZPN	MX	L	Zapoteco, Santa Inés Yatzechi
ZPO	MX	L	Zapoteco, Amatlán
ZPP	MX	L	Zapoteco, El Alto
ZPQ	MX	L	Zapoteco, Zoogocho
ZPR	MX	L	Zapoteco, Santiago Xanica
ZPS	MX	L	Zapoteco, Coatlán
ZPT	MX	L	Zapoteco, San Vicente Coatlán
ZPU	MX	L	Zapoteco, Yalálag
ZPV	MX	L	Zapoteco, Chichicapan
ZPW	MX	L	Zapoteco, Zaniza
ZPX	MX	L	Zapoteco, San Baltázar Loxicha
ZPY	MX	L	Zapoteco, Mazaltepec
ZPZ	MX	L	Zapoteco, Texmelucan
ZRO	EC	N	Záparo
ZRP	FR	E	Zarphatic
ZSL	ZM	L	Zambian Sign Language
ZSR	MX	L	Zapoteco, Rincón Sur
ZTC	MX	L	Zapoteco, Lachirioag
ZTE	MX	N	Zapoteco, Elotepec
ZTG	MX	L	Zapoteco, Xanaguía
ZTL	MX	L	Zapoteco, Santiago Lapaguía
ZTM	MX	N	Zapoteco, San Agustín Mixtepec
ZTN	MX	L	Zapoteco, Santa Catarina Albarradas
ZTP	MX	L	Zapoteco, Loxicha
ZTQ	MX	L	Zapoteco, Quioquitani Y Quierí
ZTS	MX	L	Zapoteco, Tilquiapan
ZTT	MX	N	Zapoteco, Tejalapan
ZTU	MX	L	Zapoteco, Güilá
ZTX	MX	L	Zapoteco, Zaachila
ZTY	MX	L	Zapoteco, Yatee
ZUA	NG	L	Zeem
ZUH	PG	L	Tokano
ZUL	CM	L	Zulgwa
ZUM	OM	L	Kumzari
ZUN	US	L	Zuni
ZUU	ZA	L	Zulu
ZUY	CM	N	Zumaya
ZWA	ET	L	Zay
ZYO	TZ	L	Zyoba
ZYP	MM	L	Zyphe
ZZZ	TR	L	Dimli
